8
2 0
3 6
5 1 11 5 1 3 3 9
12 14 5 10 12 7 3 10
6 9 12 13 6 3 3 9
5 8 6 8 7 3 9 12
12 14 5 10 5 3 10 12
4 3 10 5 10 7 3 10
12 5 9 6 3 1 9 13
6 10 6 3 3 10 6 10
