8
6 5
4 0
7 3 1 3 3 3 3 9
5 9 6 11 5 9 5 10
12 6 9 5 10 12 4 9
12 13 12 6 9 12 12 12
14 4 10 5 10 12 14 12
13 6 9 12 13 6 3 8
4 9 12 12 12 5 9 12
14 6 2 10 6 10 6 10
