8
7 4
4 7
5 1 9 5 3 9 7 9
12 12 6 10 13 6 3 8
14 12 7 3 2 9 5 10
5 10 5 11 5 8 6 9
4 9 12 5 8 6 11 12
14 12 12 12 6 3 9 12
5 10 12 12 7 9 6 10
6 3 10 6 3 2 3 11
