8
6 3
2 4
5 9 5 3 11 5 1 9
12 12 4 3 3 8 12 12
12 12 14 5 11 12 12 12
12 6 9 12 7 10 12 14
12 13 6 10 5 9 4 9
6 2 3 3 10 12 14 12
5 9 5 3 9 12 5 8
14 6 2 11 6 2 10 14
