8
7 1
6 5
5 1 3 9 7 3 1 11
12 6 9 6 3 9 6 9
12 13 12 5 11 12 5 8
12 12 12 6 3 2 10 12
12 12 6 3 1 9 7 8
12 4 9 13 14 6 9 14
12 14 12 6 3 9 6 9
6 3 2 3 11 6 3 10
