8
3 5
6 2
5 3 3 3 9 5 3 9
12 5 3 11 4 10 7 10
12 6 9 5 10 5 3 9
4 9 6 10 5 10 7 10
12 6 3 3 10 7 1 9
6 9 5 3 3 9 12 12
5 10 12 5 11 6 10 12
6 3 10 6 3 3 3 10
