8
0 1
6 7
5 1 9 7 1 3 9 13
14 12 12 5 10 5 10 12
5 10 6 10 13 12 5 10
12 5 1 3 10 12 6 9
12 12 14 5 3 10 5 8
12 6 9 6 9 5 10 14
4 9 6 1 10 6 3 9
14 6 11 6 3 3 3 10
