8
4 3
0 1
5 3 3 1 9 7 3 9
6 9 5 10 6 3 9 12
13 12 6 3 3 9 6 10
4 10 7 1 9 6 3 9
6 3 3 10 6 3 11 12
5 3 3 9 5 3 11 12
12 5 9 6 10 5 9 12
6 10 6 3 3 10 6 10
