8
7 6
0 4
5 3 3 3 1 11 5 9
6 9 5 9 6 3 10 12
13 12 12 6 9 5 3 8
12 12 6 9 12 12 5 10
12 12 5 10 6 10 12 13
12 14 6 9 5 11 6 8
6 3 9 12 4 3 3 10
7 3 2 10 6 3 3 11
