8
0 2
3 5
5 3 3 3 9 13 5 9
6 3 9 13 6 10 12 12
5 3 10 6 3 9 12 12
6 3 1 1 9 6 10 12
5 9 14 12 14 5 3 10
12 6 3 10 5 10 5 9
4 9 5 9 6 3 10 12
14 6 10 6 3 3 3 10
