8
6 5
2 6
5 3 9 5 9 5 1 11
12 5 10 12 6 10 6 9
12 14 5 10 5 3 3 10
12 5 10 13 12 5 3 11
4 10 13 6 10 6 3 9
6 9 6 3 1 3 3 8
13 6 3 3 10 5 9 12
6 3 3 3 3 10 6 10
