8
7 7
3 0
5 11 5 1 3 3 9 13
12 5 10 12 7 9 12 12
4 2 11 6 9 6 2 10
12 13 5 9 6 1 3 9
6 8 12 6 9 6 9 12
13 12 12 7 2 9 14 12
12 14 6 3 9 6 3 8
6 3 3 3 10 7 3 10
