8
5 5
0 7
5 3 3 3 1 3 3 11
6 3 1 11 12 5 3 9
5 3 10 5 10 12 5 10
14 5 9 4 3 10 4 9
5 10 12 14 5 9 14 12
12 13 12 5 10 12 5 8
12 6 2 10 7 2 10 12
6 3 3 3 11 7 3 10
