8
4 6
5 4
5 3 9 5 3 3 1 9
4 9 14 12 13 5 10 14
12 6 9 12 12 6 3 9
12 13 6 2 2 11 5 10
6 8 5 11 7 3 10 13
5 10 4 1 9 7 3 8
6 9 14 12 12 5 3 8
7 2 3 10 6 10 7 10
