8
2 2
0 6
5 3 3 3 1 3 3 9
6 3 3 9 12 5 9 12
5 11 5 10 6 10 12 12
4 3 10 5 9 5 10 12
6 9 5 10 14 12 5 10
5 10 12 5 3 10 6 9
12 7 8 6 3 9 5 10
6 3 10 7 3 10 6 11
