8
2 4
3 6
5 3 3 3 3 3 3 9
12 13 5 9 5 3 3 10
14 4 10 12 12 7 1 9
13 12 5 8 6 9 12 14
4 10 12 6 9 12 4 9
14 5 10 7 10 12 12 12
5 10 5 3 3 10 14 12
6 3 2 3 3 3 3 10
