8
2 6
6 3
5 3 1 11 5 1 3 9
4 11 6 3 10 6 9 12
12 5 3 3 9 5 10 12
12 6 3 9 12 4 9 12
4 11 5 10 12 12 12 14
12 5 10 5 10 14 6 9
12 12 7 8 5 3 9 12
14 6 11 6 10 7 2 10
