8
1 4
4 6
5 3 3 3 9 5 3 9
4 9 13 5 10 14 5 8
14 12 4 10 5 3 10 12
5 10 6 3 10 5 3 10
4 3 3 9 5 10 5 9
6 3 11 12 12 5 10 14
7 9 5 10 12 6 3 9
7 2 10 7 2 3 3 10
