8
3 2
3 6
5 3 9 7 3 3 3 9
12 13 6 3 3 3 3 8
14 6 3 1 3 9 13 12
5 1 3 10 5 10 12 12
14 6 9 7 2 9 12 12
5 3 8 5 9 6 10 12
12 7 10 12 12 5 3 10
6 3 3 10 6 2 3 11
