8
4 7
0 1
7 3 1 1 9 13 5 9
5 9 14 12 12 6 10 12
12 6 3 10 6 3 9 12
6 3 11 5 9 5 10 12
5 1 11 12 12 6 3 8
12 6 3 10 4 11 5 10
12 7 9 5 10 5 10 13
6 3 10 6 3 2 3 10
