8
5 4
6 4
5 9 5 3 9 5 1 9
12 6 10 5 10 12 12 14
6 3 9 12 5 10 6 9
5 9 14 4 2 3 11 12
12 6 9 14 5 3 3 8
4 9 6 3 10 5 3 10
12 12 5 3 9 12 5 9
14 6 10 7 10 6 10 14
