8
2 2
6 0
5 3 3 3 1 1 3 11
12 13 5 3 10 14 5 9
6 8 6 3 3 3 10 12
13 12 5 11 5 1 3 10
6 2 10 5 8 14 7 9
5 3 3 10 14 5 3 10
12 5 3 3 9 12 7 9
6 2 3 11 6 2 3 10
