8
7 1
4 6
5 1 3 9 13 5 1 9
14 12 5 10 6 10 12 12
5 10 6 3 3 3 10 12
12 5 3 3 9 5 11 12
12 6 9 5 10 6 3 10
4 9 12 6 3 3 3 9
12 6 10 7 1 3 11 12
6 3 3 3 10 7 3 10
