8
3 0
3 6
7 1 3 9 7 3 3 9
5 10 5 2 3 3 3 8
6 9 12 13 5 3 11 12
5 10 14 12 4 9 5 10
6 9 5 10 12 6 10 13
13 12 12 13 12 5 3 8
12 6 10 4 10 14 5 8
6 3 3 2 3 3 10 14
