8
0 2
5 2
13 5 3 3 3 9 7 9
12 6 3 9 7 2 3 8
4 3 11 6 3 11 5 10
4 3 9 5 3 3 10 13
12 5 8 12 7 3 1 10
14 12 12 6 3 9 6 9
5 10 14 5 3 10 5 8
6 3 3 2 3 3 10 14
