8
3 0
1 7
13 5 1 11 5 3 3 9
12 12 6 9 6 1 11 12
12 12 13 6 3 10 5 8
12 6 8 5 9 5 10 12
4 3 10 12 14 12 13 12
12 7 1 10 5 10 4 10
6 1 10 5 10 13 6 9
7 10 7 10 7 2 3 10
