8
7 5
2 3
5 9 7 3 9 5 1 11
12 12 5 3 8 12 6 9
12 6 8 7 10 6 9 12
12 7 8 5 3 3 10 12
6 9 12 12 5 9 5 10
5 10 12 6 10 12 6 11
4 9 6 3 11 12 7 9
14 6 3 3 3 2 3 10
