8
6 7
4 5
5 3 3 3 3 11 5 9
12 5 3 9 5 3 10 12
4 10 13 6 10 13 5 10
12 5 8 7 3 8 6 9
6 10 6 3 3 8 5 8
5 1 3 3 11 12 12 12
12 6 3 9 5 10 12 12
6 3 11 6 2 11 14 14
