8
7 6
1 0
5 3 9 5 1 3 9 13
12 7 10 12 12 7 2 8
4 3 3 10 6 3 9 12
6 3 3 9 5 9 12 14
5 9 5 10 12 12 6 9
12 12 12 5 8 14 5 8
12 12 12 14 12 5 10 12
14 6 2 3 10 14 7 10
