8
0 3
7 6
5 9 5 3 3 3 1 9
14 6 10 5 3 9 14 12
5 3 3 10 13 6 9 12
6 9 5 1 2 9 12 12
5 10 12 12 7 10 6 8
4 9 14 6 3 3 3 10
12 6 3 3 3 3 3 9
6 3 3 3 3 11 7 10
