8
5 3
0 5
5 9 5 9 5 1 3 9
12 6 10 14 12 6 9 14
12 5 3 3 2 11 6 9
6 10 7 9 5 3 3 10
5 3 9 12 4 3 3 9
6 9 6 10 6 3 9 12
5 10 5 3 9 7 10 12
6 3 10 7 2 3 3 10
