8
3 7
4 0
5 3 3 3 3 9 7 9
12 5 3 1 11 6 9 12
12 14 5 8 5 9 6 8
14 5 10 12 12 6 3 10
13 4 9 14 6 9 7 9
12 12 12 5 9 6 3 8
12 12 6 10 6 1 11 12
6 2 3 3 11 6 3 10
