8
5 1
7 7
5 3 3 3 3 3 9 13
12 5 9 5 11 5 10 12
6 10 12 6 3 2 9 12
5 9 4 3 9 5 10 12
14 12 12 5 10 6 9 12
5 10 14 12 13 5 10 12
6 3 9 12 4 10 5 8
7 3 2 10 6 3 10 14
