8
4 2
2 3
5 3 3 3 9 7 1 11
12 5 1 11 6 9 6 9
12 14 6 9 5 10 5 8
6 3 9 6 2 3 10 12
5 3 10 7 3 9 7 10
4 3 3 3 9 6 3 9
12 5 3 3 2 3 11 12
14 6 3 3 3 3 3 10
