8
2 1
7 6
5 9 5 9 5 3 1 9
12 6 10 12 12 5 10 12
12 13 5 10 14 6 9 12
12 6 10 7 1 3 10 12
6 3 9 5 10 5 9 12
5 9 12 6 3 10 12 12
12 12 6 3 3 3 10 12
14 6 3 3 3 3 3 10
