8
7 7
0 4
5 1 1 3 3 11 5 9
12 12 12 5 3 3 10 12
12 12 14 6 9 5 3 10
12 6 3 3 10 6 9 13
12 7 9 5 3 3 10 12
6 9 6 10 5 9 5 8
13 6 9 7 10 6 10 12
6 3 2 3 3 3 3 10
