8
4 4
0 1
5 3 1 11 5 1 3 9
6 9 6 9 12 6 9 14
13 12 5 10 12 13 6 9
4 10 6 3 2 2 11 12
6 1 11 5 3 3 9 12
13 12 5 8 7 3 2 8
4 10 12 14 5 11 5 10
6 11 6 3 10 7 2 11
