8
2 5
7 1
13 5 3 1 9 5 3 9
4 10 5 10 12 12 5 10
12 13 12 7 2 10 6 9
6 10 12 5 9 7 3 10
5 3 10 12 6 3 3 9
12 5 3 10 5 3 9 12
12 6 3 3 10 7 10 12
6 3 3 3 3 3 3 10
