8
7 5
2 3
7 3 1 9 7 1 9 13
5 3 10 6 9 12 6 8
12 5 9 13 6 10 5 10
12 12 12 6 3 3 2 9
12 12 6 3 3 3 9 12
12 6 9 7 1 9 12 12
4 3 10 5 8 14 12 12
6 3 3 10 14 7 10 14
