8
3 5
4 7
5 3 1 3 3 9 5 9
12 5 10 5 3 10 14 12
12 12 5 10 7 3 1 8
14 12 6 3 3 9 12 14
5 10 5 3 9 12 4 9
6 9 6 9 12 12 12 12
5 10 13 12 6 10 14 12
14 7 2 2 3 3 3 10
