8
1 5
4 7
7 1 9 5 3 1 3 9
5 10 12 14 5 10 7 10
4 9 6 9 12 5 3 11
14 12 5 10 12 12 5 11
5 10 6 3 10 12 4 9
12 5 3 3 3 10 14 12
4 10 7 1 9 5 9 12
6 3 3 10 6 10 6 10
