8
0 3
1 3
5 1 11 5 3 3 3 9
12 12 5 2 3 3 9 12
12 14 12 5 9 7 10 12
6 3 10 12 4 3 3 10
5 1 3 10 14 5 3 11
12 12 5 3 9 12 7 9
12 14 6 9 6 10 5 8
6 3 3 2 3 3 10 14
