8
1 3
5 1
5 3 1 9 5 3 3 9
4 11 12 12 12 5 11 14
14 5 10 6 8 6 3 9
5 10 13 5 10 5 9 12
6 9 6 10 5 10 6 10
5 10 5 9 12 5 1 9
4 3 10 6 10 14 12 12
6 3 3 3 3 3 10 14
