8
2 7
5 7
5 3 3 9 5 9 7 9
6 9 7 2 10 6 9 12
5 10 5 3 3 9 6 8
12 5 10 5 9 6 9 14
12 6 3 10 6 9 6 9
4 3 3 3 3 10 5 8
6 9 13 7 9 5 10 12
7 2 2 11 6 10 7 10
