8
6 3
4 5
5 3 9 5 3 3 3 9
12 13 12 12 13 5 3 8
6 10 4 2 10 6 9 12
5 9 14 5 3 3 10 12
14 6 9 12 13 5 3 10
5 11 12 12 12 12 5 9
12 5 10 12 12 6 10 12
6 2 3 10 6 3 3 10
