8
6 3
2 3
5 3 3 3 9 5 1 11
12 7 3 3 10 12 6 9
4 3 3 3 3 2 11 12
12 7 1 9 5 11 5 8
12 5 10 6 10 5 10 12
12 12 5 3 3 10 13 12
6 8 6 3 3 9 6 10
7 2 3 3 11 6 3 11
