8
2 3
2 1
5 3 1 9 7 1 3 9
6 9 12 6 9 12 13 12
5 10 6 9 4 10 6 8
14 5 3 10 12 5 11 12
5 10 7 3 10 6 9 12
4 3 3 3 3 9 12 14
12 5 9 5 3 10 6 9
6 10 14 6 3 3 3 10
