8
2 0
6 6
13 5 9 5 3 1 9 13
4 10 12 12 13 12 14 12
6 9 12 12 12 6 3 10
13 12 12 12 4 9 7 9
4 10 6 10 12 6 9 12
6 9 7 1 8 13 12 12
13 6 9 14 12 12 6 8
6 3 2 3 10 6 3 10
