8
4 7
1 6
13 5 3 3 9 13 5 9
12 6 9 13 6 10 14 12
4 11 12 4 3 3 9 12
4 9 6 10 5 3 10 12
12 12 5 3 10 5 9 12
12 6 10 7 1 10 12 12
6 9 5 9 12 5 10 12
7 2 10 6 10 6 3 10
