8
1 3
2 5
13 5 1 3 9 7 1 11
12 12 12 7 2 9 6 9
6 10 4 3 9 6 3 8
5 9 6 11 12 7 9 12
12 6 3 9 6 9 4 10
14 5 9 6 3 10 6 9
5 10 6 9 5 1 11 12
6 3 11 6 10 6 3 10
