8
2 4
3 4
13 5 1 9 5 9 7 9
4 10 12 6 10 6 9 12
6 9 12 7 1 3 10 12
7 10 4 9 12 5 3 8
5 9 12 12 12 12 7 8
14 12 14 12 12 6 9 12
13 12 5 10 6 9 12 12
6 2 10 7 3 2 10 14
