8
1 4
3 2
5 9 7 1 9 7 1 11
12 6 3 10 6 9 4 9
4 9 13 5 9 12 12 12
12 12 4 10 12 12 14 12
14 12 12 5 10 12 5 10
5 10 12 12 5 10 12 13
12 7 10 6 2 3 10 12
6 3 3 3 3 3 3 10
