8
3 2
4 3
5 9 7 1 3 9 5 9
12 12 5 10 5 10 12 12
12 6 10 7 2 3 10 12
4 9 7 3 3 9 7 8
14 4 9 5 9 6 9 12
5 10 6 8 14 5 10 12
4 3 9 14 5 10 13 12
6 11 6 3 10 7 2 10
