8
6 1
6 5
5 3 3 3 9 5 3 9
4 3 3 9 6 10 13 12
12 5 3 8 7 3 8 12
14 12 7 10 7 9 12 12
5 8 5 1 11 12 12 12
12 12 12 6 3 10 4 10
12 14 12 5 9 5 10 13
6 3 10 14 6 2 3 10
