8
3 6
1 6
5 3 1 9 5 9 5 9
6 9 12 12 12 12 14 12
7 10 12 6 10 6 3 8
5 3 8 5 3 3 9 12
4 9 12 6 9 5 10 12
12 12 14 5 10 6 9 12
12 6 9 4 11 5 10 12
6 11 6 10 7 10 7 10
