8
0 5
1 5
5 1 3 11 5 3 1 9
12 6 3 3 10 13 12 14
6 3 9 5 3 8 6 9
5 11 12 6 11 4 9 14
6 9 6 3 9 12 6 11
5 2 3 11 12 6 1 9
4 9 5 9 6 9 14 12
14 6 10 6 3 2 3 10
