8
4 2
3 4
13 5 9 13 5 1 9 13
12 12 12 6 10 12 6 8
12 12 14 5 9 6 9 12
12 12 5 8 6 3 10 12
12 12 12 12 5 1 9 12
4 10 12 12 12 12 12 12
6 9 14 12 12 12 14 12
7 2 3 10 14 6 3 10
