8
5 4
6 7
13 5 3 1 9 7 1 9
4 10 5 10 6 9 12 12
14 5 10 5 9 6 10 14
5 10 5 10 6 3 3 9
4 9 6 3 9 13 7 10
14 4 9 13 6 2 9 13
5 10 6 2 11 5 10 12
6 3 3 3 3 2 3 10
