8
6 5
4 6
5 1 3 3 1 11 5 9
14 6 9 5 10 5 10 12
5 3 10 6 11 12 7 10
12 5 3 3 3 10 7 9
12 12 7 3 1 3 3 8
12 6 3 9 12 7 1 10
4 9 5 10 6 9 12 13
14 6 2 3 3 10 6 10
