8
0 0
5 7
5 3 3 9 5 9 7 9
6 11 5 10 12 6 3 8
5 11 6 3 10 13 5 10
6 3 9 5 9 4 10 13
5 9 12 12 6 10 7 8
12 4 10 12 5 1 3 8
12 14 5 10 14 12 5 10
6 3 2 3 3 10 6 11
