8
6 6
3 3
5 1 3 3 9 5 1 9
14 12 5 9 14 12 12 14
5 10 12 6 3 10 6 9
12 5 2 3 3 3 11 12
12 6 9 5 3 3 3 10
4 3 10 14 5 3 3 9
12 7 3 3 8 5 3 10
6 3 3 3 10 6 3 11
