8
2 6
0 0
5 11 5 3 9 5 3 9
12 13 12 13 12 6 11 12
12 6 10 4 10 5 9 12
12 5 3 10 5 10 6 8
12 6 9 5 10 5 9 12
6 9 12 6 3 10 12 14
5 10 6 3 3 9 6 9
6 3 3 3 3 2 3 10
