8
0 2
6 2
5 3 3 3 1 3 3 11
6 3 1 11 4 3 3 9
13 5 10 13 4 11 5 10
4 10 13 12 14 5 10 13
12 7 8 6 3 10 5 10
12 5 2 3 9 7 2 9
12 12 5 3 10 5 3 8
6 10 6 3 3 10 7 10
