8
4 3
2 1
13 7 9 7 1 9 5 9
4 9 6 9 12 12 12 12
12 14 5 10 12 12 14 12
4 3 10 7 8 12 5 8
6 3 9 5 10 6 10 14
5 3 10 6 1 3 3 9
6 3 3 9 6 3 11 12
7 3 3 2 3 3 3 10
