8
6 4
0 2
7 3 3 9 5 3 3 9
5 3 3 8 12 13 5 10
12 5 3 10 6 8 6 9
12 6 11 5 9 6 9 12
4 3 3 10 6 3 10 12
6 9 5 9 5 3 3 8
7 10 12 12 6 9 5 10
7 3 10 6 3 10 6 11
