8
6 5
7 1
13 5 9 5 3 3 1 9
6 10 6 2 9 5 10 12
5 3 9 7 10 12 7 8
4 9 6 3 9 4 9 12
14 12 7 9 12 12 12 14
5 10 13 4 10 14 6 9
4 9 12 6 9 5 3 8
14 6 10 7 2 10 7 10
