8
0 5
1 3
5 3 9 5 9 5 1 11
6 9 6 10 12 12 6 9
5 10 5 3 10 6 9 12
4 9 6 3 3 9 12 12
12 6 9 5 9 12 14 12
6 11 12 12 14 6 3 8
5 3 10 6 3 3 9 12
6 3 3 3 3 3 10 14
