8
1 0
3 7
13 5 3 3 1 9 5 9
12 12 13 5 10 6 10 14
12 6 8 6 3 3 3 9
12 5 10 5 1 3 11 12
4 10 5 10 12 5 9 12
12 5 10 13 12 12 6 8
6 10 13 4 10 12 13 12
7 3 2 2 11 6 10 14
