8
7 4
3 0
5 11 5 3 3 1 3 9
4 3 2 3 11 12 13 12
6 1 11 5 3 10 12 12
13 12 5 10 5 3 2 10
12 12 6 9 6 3 3 9
12 12 5 10 5 11 5 10
12 12 6 9 6 9 6 9
6 2 11 6 11 6 3 10
