8
4 1
6 7
5 3 11 5 3 3 3 9
4 9 5 10 5 3 9 12
12 12 12 7 10 5 10 12
12 12 6 3 9 6 9 12
12 6 3 9 4 3 10 12
12 7 9 6 10 5 3 8
6 9 12 5 11 12 5 10
7 2 10 6 3 10 6 11
