8
0 7
7 0
5 9 7 1 1 3 3 11
12 6 3 10 12 5 3 9
6 3 3 9 14 6 9 12
5 3 9 6 1 11 12 12
6 9 6 9 4 9 12 12
13 12 13 12 14 6 10 12
4 10 6 10 5 9 5 8
6 3 3 3 10 6 10 14
