8
6 4
7 6
5 9 5 1 3 9 5 11
14 6 10 12 13 12 6 9
5 3 3 10 12 12 5 8
12 5 3 9 4 10 12 12
12 12 5 10 12 7 8 12
12 14 6 3 2 3 10 12
12 5 3 9 7 9 13 12
6 2 11 6 3 10 6 10
