8
7 2
4 3
7 3 1 3 3 3 1 9
5 9 6 3 3 9 12 14
12 6 3 9 5 10 6 9
6 9 5 10 6 3 9 12
5 10 12 5 9 7 10 12
12 13 12 12 6 9 5 8
12 6 2 10 13 6 10 12
6 3 3 11 6 3 3 10
