8
3 2
0 1
7 1 3 9 5 3 9 13
5 10 13 12 6 9 12 12
12 7 2 0 3 10 6 8
12 5 9 14 5 9 5 10
12 12 6 3 10 14 6 11
12 6 3 3 3 3 3 9
12 5 3 1 3 3 11 12
6 2 11 6 3 3 3 10
