8
0 1
0 3
5 1 9 5 1 3 3 11
14 12 12 12 6 3 3 9
5 10 12 6 11 5 9 12
12 7 2 3 9 12 12 12
6 3 3 9 6 10 6 8
5 3 3 10 5 3 11 12
4 3 3 9 6 3 1 10
6 3 11 6 3 11 6 11
