8
6 3
0 7
7 1 3 3 3 3 3 9
5 10 5 3 3 9 13 12
6 3 10 5 9 14 12 12
13 5 9 12 6 3 2 10
6 10 12 6 3 3 9 13
5 3 8 5 1 9 6 8
12 7 10 12 12 14 5 10
6 3 3 10 6 3 2 11
