8
0 3
6 7
13 5 1 3 3 9 5 9
4 10 12 5 3 10 12 12
6 9 12 12 7 3 8 12
13 14 12 6 3 9 14 12
12 5 10 5 11 6 3 8
12 6 9 6 9 5 3 10
6 9 6 9 12 12 7 9
7 2 3 10 6 2 3 10
