8
2 5
5 0
5 3 3 9 5 3 11 13
12 7 3 0 10 5 3 10
4 3 9 14 5 10 5 9
6 9 6 9 12 5 10 12
5 10 5 10 12 12 13 12
12 13 12 5 10 6 10 12
12 12 12 12 5 3 9 12
6 10 6 2 10 7 2 10
