8
4 0
1 7
5 9 13 5 3 1 3 9
12 12 6 2 11 6 9 14
12 6 9 5 3 9 4 9
12 7 2 10 5 10 14 12
6 3 9 7 2 3 9 12
5 3 10 5 3 9 12 12
12 5 3 10 13 12 6 8
6 2 3 3 10 6 11 14
