8
1 6
6 0
5 11 5 3 9 5 3 9
6 9 12 13 6 10 13 12
5 10 6 2 9 5 8 12
12 5 3 9 6 10 12 14
12 12 5 8 5 9 6 9
4 10 12 6 10 6 11 12
6 9 12 5 3 3 9 12
7 10 6 2 3 11 6 10
