8
1 5
0 1
13 5 1 3 3 1 3 11
12 12 12 7 3 10 5 9
12 12 12 5 3 3 10 12
12 12 12 6 1 11 5 10
12 12 6 3 10 13 12 13
12 12 7 1 9 6 10 12
12 6 9 12 12 5 3 8
6 3 2 10 6 10 7 10
