8
0 1
3 6
5 9 5 3 3 3 3 9
12 12 6 3 9 7 9 12
14 12 5 3 2 3 10 12
5 10 6 9 5 3 3 8
4 3 3 10 12 5 3 10
6 11 5 9 12 6 9 13
7 3 10 6 10 13 6 8
7 3 3 3 3 2 3 10
