8
2 0
5 3
7 1 9 13 5 1 3 11
5 10 12 4 10 6 3 9
12 7 8 6 3 11 5 8
6 9 4 3 3 3 10 14
5 10 12 5 3 3 3 9
12 13 12 12 7 9 13 12
12 6 10 6 3 8 12 12
6 3 3 3 3 10 6 10
