8
7 3
2 3
7 3 9 5 9 7 3 9
5 3 10 12 4 9 5 10
4 3 3 10 12 14 12 13
4 11 5 9 12 5 10 12
12 5 10 6 10 6 9 12
14 6 3 3 3 9 12 12
5 3 3 3 3 10 12 12
6 3 3 3 3 3 2 10
