8
6 1
1 4
13 5 9 5 1 3 3 11
12 12 12 12 6 3 3 9
4 10 6 2 3 9 5 8
12 7 9 5 11 12 12 12
12 5 8 12 7 8 12 12
12 12 14 6 9 14 12 12
12 6 9 5 10 5 10 12
6 3 10 6 3 10 7 10
