8
2 5
2 3
5 3 9 5 1 3 3 9
12 5 10 12 12 5 3 10
12 6 9 14 12 6 9 13
12 13 12 13 6 9 6 8
12 12 6 10 5 10 13 12
12 6 1 9 6 9 4 10
12 5 10 12 5 10 12 13
6 10 7 2 10 7 2 10
