8
0 7
2 3
5 3 3 3 3 3 3 9
6 3 3 9 5 11 5 8
5 3 9 14 6 9 12 14
6 9 12 5 9 12 6 9
13 12 12 12 6 10 5 10
12 12 12 12 5 9 4 9
12 12 6 10 12 12 14 12
6 2 3 3 10 6 3 10
