8
3 4
7 7
5 9 5 1 9 5 1 11
12 6 10 12 14 12 6 9
12 5 9 6 3 2 11 12
12 12 6 9 5 3 3 8
12 14 5 10 12 5 11 12
6 9 12 5 10 4 3 10
5 10 12 12 5 10 7 9
6 11 6 10 6 3 3 10
