8
1 5
5 6
5 9 5 1 11 5 1 11
12 14 12 6 9 12 6 9
6 3 2 9 6 10 5 8
5 3 9 14 5 3 10 14
4 9 12 5 8 5 3 9
12 12 12 12 14 6 9 14
12 12 6 10 5 9 12 13
14 6 3 3 10 6 2 10
