8
0 4
6 4
7 9 5 3 9 5 1 11
5 10 6 9 6 10 6 9
4 3 3 10 5 3 9 12
12 5 3 11 12 13 12 12
6 8 13 5 10 4 10 12
13 12 12 12 7 2 3 8
12 12 12 6 3 9 5 10
6 10 6 3 3 10 6 11
