8
2 7
0 4
13 5 3 3 9 5 3 11
12 6 3 9 12 4 3 9
6 9 7 10 12 12 5 8
5 0 3 11 12 12 12 12
12 14 5 3 10 14 12 12
6 9 12 7 1 3 10 12
5 10 6 9 12 13 5 10
6 3 3 2 10 6 2 11
