8
1 2
2 5
5 11 5 1 3 3 3 11
4 9 12 12 5 3 3 9
12 6 10 6 10 5 9 12
6 3 11 5 3 10 6 8
5 9 5 8 7 3 3 8
12 6 10 14 5 3 9 14
12 5 9 5 10 13 6 11
6 10 6 2 3 2 3 11
