8
0 6
6 4
13 5 1 3 3 9 5 9
4 10 6 9 7 10 12 12
12 5 9 6 1 3 10 12
12 12 6 9 6 9 5 10
14 12 13 6 9 12 6 9
7 10 6 9 12 14 5 8
5 3 3 10 6 3 10 12
6 3 3 3 3 3 3 10
