8
5 7
7 3
5 3 3 1 9 5 1 9
12 5 11 14 12 12 12 14
12 6 3 9 4 10 6 9
12 5 3 10 14 5 9 12
14 12 7 1 3 10 6 8
5 10 5 10 13 5 9 12
12 5 10 13 4 10 12 12
6 10 7 2 2 11 6 10
