8
6 5
1 3
5 3 9 7 3 1 9 13
12 5 10 5 3 10 12 12
12 6 9 12 5 9 6 8
12 13 6 10 14 4 11 12
12 4 1 3 3 10 5 10
12 12 6 3 9 5 10 13
12 6 11 5 10 6 9 12
6 3 11 6 3 3 2 10
