8
1 5
1 2
5 9 7 1 3 3 9 13
12 12 5 10 13 5 10 12
12 12 4 9 6 2 3 8
14 12 14 12 5 9 13 12
13 6 9 6 10 12 12 12
4 3 10 5 9 12 12 12
6 9 7 8 6 10 12 12
7 2 3 10 7 3 2 10
