8
3 4
7 7
5 3 9 5 3 3 3 9
12 13 6 10 5 3 3 10
6 8 7 9 14 5 3 9
13 6 9 4 9 6 11 12
4 11 6 10 12 5 3 8
4 3 3 9 12 12 5 10
6 3 9 6 10 12 6 9
7 3 2 3 3 10 7 10
