8
5 4
3 2
13 5 3 1 3 3 9 13
4 10 5 10 5 9 12 12
12 13 12 7 10 4 10 12
6 10 12 5 9 6 3 8
5 3 10 12 6 9 5 10
4 3 9 12 13 12 6 9
12 13 12 6 8 12 5 10
6 10 6 3 10 14 6 11
