8
0 6
0 1
13 5 3 3 3 3 3 9
4 2 3 3 11 5 3 8
12 5 3 3 9 4 9 14
12 12 5 9 12 14 6 9
12 14 12 14 6 9 5 10
12 13 4 3 3 10 6 9
6 8 6 9 7 1 9 12
7 2 11 6 3 10 6 10
