8
7 5
6 5
5 3 3 1 3 1 9 13
14 5 9 6 9 12 12 12
7 10 6 9 14 12 12 12
5 3 11 6 3 10 6 8
4 3 3 3 1 9 13 12
6 3 3 9 12 6 10 12
5 3 11 12 6 3 3 10
6 3 3 2 3 3 3 11
