16
5 3
8 10
5 11 5 3 3 3 9 5 3 1 11 5 3 3 1 9
4 3 10 5 3 9 12 12 13 6 3 2 3 11 12 14
6 3 9 4 9 14 6 2 2 3 9 5 3 9 6 9
5 9 12 14 6 9 5 3 3 9 14 6 9 6 3 8
12 14 6 9 5 10 12 5 11 12 5 9 4 9 7 8
4 3 9 12 6 9 12 6 3 2 10 12 14 4 9 14
6 9 6 10 5 8 12 5 9 7 9 6 9 14 6 9
13 6 3 9 12 12 6 10 6 9 4 11 6 9 5 8
4 3 9 12 12 12 5 3 9 12 4 9 5 10 12 12
12 5 8 6 10 6 10 5 10 12 12 6 10 7 8 14
12 12 6 3 3 11 5 2 11 12 12 7 1 9 4 9
12 6 3 3 3 3 10 5 3 10 6 9 12 12 14 12
12 5 3 9 7 1 9 12 13 5 9 6 10 6 3 8
6 10 13 12 5 10 12 12 4 10 4 11 5 1 11 12
13 5 8 6 10 5 10 12 12 13 6 9 12 6 9 12
6 10 6 3 3 10 7 10 6 2 11 6 2 11 6 10
