16
1 11
2 3
7 1 9 5 3 1 11 5 3 9 5 3 3 3 3 9
5 10 14 6 9 6 3 10 5 10 6 9 7 1 11 12
12 5 3 3 10 5 3 9 6 3 9 6 3 8 5 10
12 6 9 5 3 10 5 2 3 11 12 7 3 10 4 9
4 11 6 10 7 9 6 9 7 3 10 5 3 9 14 12
12 5 1 3 3 2 9 6 9 5 3 8 7 2 9 12
4 10 12 7 3 3 0 11 12 4 9 14 5 9 6 10
6 9 6 3 3 9 12 5 10 12 6 3 10 6 3 9
5 10 5 3 1 10 14 12 5 10 7 3 9 5 9 12
12 13 12 13 12 5 3 10 4 3 3 3 10 12 6 8
6 8 12 6 10 12 7 3 10 5 3 3 9 6 9 12
5 10 6 3 9 6 3 3 3 10 5 11 12 5 10 14
12 7 9 5 2 3 3 9 5 11 4 3 10 6 3 9
12 5 8 12 5 3 11 12 12 5 10 5 3 9 5 8
6 10 12 12 6 3 3 2 10 6 3 10 13 6 10 12
7 3 10 6 3 3 3 3 3 3 3 3 2 3 3 10
