16
3 4
9 10
13 5 3 1 11 5 1 3 3 3 9 7 3 3 1 9
12 12 13 6 3 10 6 9 5 11 4 3 3 3 10 12
4 10 4 1 3 9 13 12 6 3 10 5 3 9 7 8
12 5 10 6 9 6 8 6 3 3 3 10 13 6 9 12
12 12 7 9 6 9 12 5 3 11 5 9 4 9 12 14
12 6 3 0 11 12 6 8 5 3 10 6 10 12 6 9
6 9 7 8 5 10 5 10 12 7 1 11 5 8 13 12
13 6 9 12 6 9 6 9 6 1 10 5 10 4 10 12
4 9 12 12 13 12 7 10 5 10 5 10 5 10 5 10
12 12 12 6 8 6 3 9 12 5 10 5 10 13 6 9
12 14 6 9 6 3 11 6 10 12 13 4 3 2 11 12
4 3 9 12 5 3 3 3 3 8 6 10 5 3 3 10
6 9 6 10 12 5 3 3 3 10 5 3 10 5 9 13
5 10 5 9 12 6 3 9 7 9 12 5 9 12 12 12
12 7 8 6 10 5 9 6 9 12 6 10 6 10 14 12
6 3 10 7 3 10 6 3 2 2 3 3 3 3 3 10
