16
10 15
6 8
13 5 3 3 9 5 1 3 3 3 3 11 5 3 3 9
12 6 9 13 12 12 6 3 3 3 3 1 10 5 3 8
4 9 4 10 6 2 3 11 5 3 9 6 9 12 7 8
12 6 10 5 3 9 5 9 6 9 12 13 12 6 9 12
6 3 9 12 13 12 12 6 9 12 12 12 12 5 10 12
5 9 12 6 8 6 10 5 10 12 12 6 8 12 13 12
12 6 10 13 12 5 11 6 3 10 6 9 12 12 6 8
6 9 5 8 12 4 3 1 3 9 13 12 12 6 9 14
5 10 12 14 12 4 11 12 5 10 6 10 6 11 6 9
12 5 2 9 12 14 5 10 6 3 3 3 3 3 3 10
12 6 11 12 6 9 12 5 1 3 3 11 5 1 9 13
6 3 9 4 9 6 10 14 4 3 3 3 10 12 12 12
5 9 6 10 12 7 1 9 14 5 3 9 5 10 6 8
12 6 1 11 6 9 12 6 9 12 13 12 12 5 11 12
6 9 6 1 11 6 10 13 6 10 4 10 12 4 3 10
7 2 11 6 3 3 3 2 3 3 2 3 10 6 3 11
