16
0 0
8 4
5 1 11 5 9 5 3 3 3 1 9 7 1 3 3 11
12 12 5 10 6 10 5 3 9 12 6 9 4 3 3 9
12 6 10 5 3 3 2 11 12 6 9 12 14 5 3 10
12 5 3 10 5 3 3 9 4 9 12 6 9 6 3 9
12 6 11 5 10 5 11 6 10 12 6 9 12 5 9 12
6 9 5 10 5 8 5 9 5 10 13 12 4 10 6 8
13 12 12 5 10 12 12 6 10 7 8 12 14 5 9 14
12 12 12 12 13 12 12 5 3 9 12 6 3 10 6 9
12 6 10 6 8 6 10 12 13 6 2 9 5 3 9 12
4 3 11 5 10 5 3 8 4 3 11 12 12 7 8 12
6 9 5 10 7 10 5 8 6 3 1 10 6 9 6 10
5 10 12 5 3 3 10 14 5 11 6 1 11 6 9 13
4 9 12 6 3 1 3 9 6 3 9 14 5 3 10 12
12 6 10 5 9 6 11 4 3 9 6 3 10 5 3 8
12 7 1 10 6 3 3 10 13 6 9 5 9 14 5 8
6 3 10 7 3 3 3 3 2 3 2 10 6 3 10 14
