16
3 5
10 10
7 1 3 11 5 9 5 1 3 9 5 1 3 3 3 9
5 8 5 9 12 6 10 6 9 12 12 6 3 9 5 10
12 12 12 12 12 5 1 11 12 14 12 13 5 10 6 9
12 14 12 6 10 14 12 13 12 5 10 12 12 5 11 12
12 5 10 5 1 1 10 12 6 2 3 10 12 12 5 10
12 12 5 10 12 12 5 10 5 3 3 9 12 4 10 13
4 10 14 5 10 12 12 5 10 7 3 2 10 12 7 8
6 9 5 10 7 10 12 12 5 3 3 9 7 2 3 8
13 6 8 5 3 3 10 12 6 3 9 6 9 7 9 12
12 5 10 6 9 7 3 0 3 11 12 13 6 9 6 10
4 2 11 5 10 5 3 10 5 3 2 2 11 6 3 9
6 9 5 10 13 4 3 3 10 5 1 3 3 3 3 8
13 12 12 5 10 12 5 3 9 12 14 5 3 3 9 12
12 12 12 6 9 12 14 5 10 6 3 2 9 5 10 14
12 12 6 9 6 2 3 10 5 3 3 9 14 6 3 9
6 2 11 6 3 3 3 3 10 7 3 2 3 3 3 10
