16
4 8
14 4
7 3 3 1 3 9 5 9 5 3 9 5 3 3 1 11
5 3 3 8 7 2 10 12 6 9 12 6 3 11 4 9
4 3 9 14 5 9 7 2 9 12 6 9 5 9 14 12
12 13 6 9 12 6 9 13 12 12 13 6 10 6 9 12
12 6 9 12 12 5 10 12 6 10 4 1 3 11 6 8
6 3 8 6 10 12 5 0 3 11 12 12 5 3 9 12
5 11 12 5 3 10 12 14 5 3 10 12 6 9 6 10
12 5 10 12 5 11 4 3 10 7 9 4 9 12 7 9
4 10 13 12 6 1 10 7 1 3 8 12 14 12 5 10
6 3 8 6 9 6 9 5 10 7 10 6 3 10 6 9
5 11 12 5 10 5 10 12 5 3 3 3 3 1 1 10
4 3 10 12 5 10 5 2 10 5 3 3 9 14 6 9
14 5 3 10 6 9 6 11 5 10 7 3 2 3 3 10
5 10 5 3 3 2 3 9 12 5 9 5 3 3 3 9
12 7 10 5 9 5 9 6 10 12 12 12 5 3 9 12
6 3 3 10 6 10 6 3 3 10 6 2 10 7 10 14
