16
3 1
15 10
7 9 5 9 5 3 3 1 3 3 3 3 3 3 9 13
5 10 12 12 12 5 9 6 3 9 5 1 3 9 12 12
12 5 10 6 10 12 6 3 9 12 14 12 7 10 6 8
6 10 5 3 3 10 5 3 10 6 9 6 3 1 3 10
5 9 12 5 9 13 12 7 1 3 10 5 9 6 3 9
12 12 4 10 12 12 6 9 4 9 5 10 12 7 9 12
12 12 6 11 12 6 1 10 14 12 6 9 6 9 4 10
12 6 3 9 6 9 12 5 3 8 5 10 13 12 6 11
12 5 9 6 3 10 12 12 5 10 12 5 8 6 3 9
4 10 6 3 9 5 2 10 6 9 6 8 14 5 9 12
12 5 3 9 12 14 5 9 7 10 5 10 5 10 6 8
12 12 13 12 6 9 12 6 3 3 10 5 10 7 3 10
6 10 12 12 5 10 6 3 1 11 5 8 5 3 3 9
13 5 2 10 6 3 9 5 10 5 10 14 6 3 9 14
12 6 9 5 3 9 12 12 13 6 9 5 9 5 10 13
6 3 2 10 7 10 6 2 2 11 6 10 6 2 3 10
