16
4 5
5 8
5 3 3 3 9 5 3 3 3 1 9 7 1 3 9 13
12 13 5 9 6 10 7 3 9 12 6 9 12 7 2 8
12 4 10 6 3 3 1 9 12 14 5 10 6 9 7 10
12 14 5 9 5 3 10 12 6 3 10 7 1 10 5 9
6 3 10 6 10 5 3 10 5 3 3 3 10 5 10 12
5 3 3 1 11 12 7 1 2 3 9 5 3 10 5 8
14 5 9 6 9 6 9 12 5 3 8 6 3 9 12 12
5 10 6 9 4 11 12 14 6 9 14 5 3 10 12 12
12 5 11 12 6 9 6 3 9 6 1 10 5 3 10 12
12 6 3 2 3 2 3 11 6 9 6 9 12 7 3 8
4 9 5 3 9 5 3 3 9 6 9 14 6 1 9 14
12 12 12 5 10 6 3 9 4 9 12 5 9 14 6 9
12 6 10 6 3 9 5 10 12 12 6 10 6 3 9 12
6 3 3 9 13 12 12 5 10 6 9 5 1 11 6 8
5 3 9 12 12 12 12 12 5 9 14 12 6 3 9 12
6 11 6 2 10 6 10 6 10 6 3 2 3 11 6 10
