16
1 4
8 5
5 3 9 7 1 3 9 5 3 3 9 7 1 3 3 9
4 9 6 9 12 7 8 6 9 13 12 5 10 5 11 12
12 12 13 12 6 9 12 5 10 6 8 12 13 4 3 10
12 12 6 2 9 12 12 6 1 9 12 12 12 12 5 9
12 6 9 7 2 10 6 9 14 12 6 10 12 12 12 12
12 13 12 5 9 5 3 2 9 6 9 5 2 10 14 12
12 12 6 10 12 14 5 9 12 5 10 12 5 3 9 12
6 2 3 9 6 3 10 12 6 10 13 12 12 7 0 10
5 3 9 6 3 9 13 6 3 9 6 8 6 9 14 13
6 11 4 3 9 12 4 1 9 6 9 6 3 8 5 10
5 3 10 5 10 12 12 12 14 5 10 7 3 10 12 13
6 9 7 2 11 12 14 6 9 6 3 3 3 9 12 12
5 10 5 3 9 6 9 5 2 3 9 5 3 10 12 12
4 9 12 13 4 11 12 12 5 9 12 12 5 9 6 8
12 12 6 8 6 9 12 12 12 6 10 12 12 6 9 12
14 6 3 2 11 6 2 10 6 3 11 6 2 11 6 10
