16
11 8
14 7
5 3 3 3 3 9 7 9 5 3 3 1 9 5 1 11
12 5 9 7 3 2 3 10 12 5 11 12 14 12 6 9
6 10 6 9 5 3 3 9 6 8 5 10 5 10 5 10
5 3 9 6 2 3 9 6 3 10 6 9 12 13 6 9
12 5 8 5 3 9 6 9 7 3 9 6 10 12 5 10
12 12 14 6 9 12 7 2 3 3 8 5 3 8 6 9
12 12 5 3 10 6 9 7 1 11 12 12 7 8 13 12
12 6 10 7 3 9 12 5 10 5 10 4 9 6 10 12
12 5 1 3 3 10 12 12 5 10 7 10 6 9 5 10
12 14 6 3 9 5 10 4 10 5 1 3 3 10 6 9
6 9 5 3 8 12 13 12 7 8 12 5 3 3 3 10
13 12 6 9 14 12 12 6 3 10 12 12 5 9 5 9
4 10 5 8 5 10 4 3 1 11 12 6 10 4 10 12
6 3 10 12 6 11 12 13 6 3 8 5 9 6 11 12
5 3 9 6 3 9 6 10 5 9 14 12 12 5 3 8
6 11 6 3 3 2 3 3 10 6 3 10 6 10 7 10
