16
4 9
12 3
5 3 3 11 5 3 3 1 9 7 3 1 9 7 3 9
4 3 3 3 10 5 3 10 4 3 3 10 12 5 3 8
6 11 5 3 9 12 5 3 10 5 9 7 2 10 5 10
5 3 10 13 4 10 14 5 9 12 6 9 5 11 12 13
12 5 9 4 10 5 3 10 6 10 13 12 4 9 6 8
12 14 12 6 9 6 3 9 5 3 8 12 14 6 3 10
4 9 4 11 12 13 5 10 6 9 12 6 3 3 3 9
12 12 4 9 4 10 12 5 9 12 6 9 5 3 11 12
12 12 12 6 10 5 10 12 6 10 13 12 12 5 9 12
12 12 14 5 9 12 5 8 13 5 2 10 6 10 12 12
12 6 3 10 6 10 14 12 12 12 5 3 9 5 10 12
12 7 3 1 3 3 9 12 4 2 10 7 2 8 5 8
6 3 3 10 13 5 2 10 14 5 3 3 9 14 12 14
5 3 1 9 12 6 9 5 11 12 7 9 6 9 6 9
12 13 12 6 10 5 10 12 5 10 5 2 11 12 5 8
6 10 6 3 3 2 11 6 10 7 2 3 3 2 10 14
