16
3 0
9 6
5 3 1 3 3 9 5 9 5 3 3 9 7 3 3 9
4 9 14 5 9 6 8 14 12 5 11 6 3 9 5 8
12 6 3 10 12 7 10 5 10 4 3 1 11 6 10 12
12 7 3 9 6 3 9 14 7 2 9 12 5 3 9 12
6 3 3 2 9 5 8 5 3 9 14 12 12 13 12 12
5 3 3 9 14 12 6 10 13 6 3 8 12 12 6 10
12 7 3 2 3 10 5 3 2 3 3 10 6 8 7 9
4 3 3 9 7 3 8 7 1 3 3 9 5 10 5 8
6 1 11 12 5 9 6 3 10 7 3 10 12 5 8 14
13 12 5 8 12 6 3 3 9 5 3 3 10 12 6 9
4 10 12 12 6 9 7 9 6 10 5 11 5 10 5 8
14 5 10 12 5 10 5 8 5 3 2 9 12 5 10 12
5 10 13 12 6 3 10 12 6 1 11 6 10 12 13 12
12 13 4 2 3 9 13 6 9 14 5 9 5 10 12 12
12 6 10 5 9 6 2 11 6 3 10 6 10 5 10 12
6 3 3 10 6 3 3 3 3 3 3 3 3 2 3 10
