16
8 6
15 0
5 3 3 11 5 1 3 3 11 5 3 3 3 3 1 9
12 5 3 9 12 6 3 3 3 8 7 9 5 9 14 12
12 12 5 10 6 9 5 3 9 12 5 8 12 6 3 10
4 10 6 3 9 12 12 5 10 6 10 14 6 1 3 9
6 3 3 9 6 10 12 12 7 1 3 3 9 6 11 12
5 3 3 10 5 9 12 6 9 4 3 9 6 3 3 8
14 5 3 9 12 12 6 9 12 14 5 10 13 5 3 10
5 10 13 6 10 6 9 12 12 5 10 5 2 10 7 9
6 3 2 1 11 5 10 12 12 4 9 12 5 3 9 12
7 1 9 12 5 10 7 8 12 12 12 6 10 13 12 12
5 10 12 12 6 9 5 10 12 12 12 13 5 2 10 12
12 5 10 12 13 14 6 9 12 14 12 12 6 9 5 8
12 6 11 12 12 5 1 10 4 3 10 6 3 8 12 12
12 5 3 10 6 10 12 7 10 5 3 3 9 12 12 12
12 12 5 9 5 9 6 3 3 2 3 11 12 6 10 12
6 2 10 6 10 6 3 3 3 3 3 3 10 7 3 10
