16
7 8
7 13
5 1 9 5 3 3 1 3 11 5 3 9 5 9 7 9
12 12 6 10 5 9 12 5 3 10 13 12 12 6 3 8
12 6 9 7 8 6 10 6 11 13 4 10 12 5 3 10
6 11 6 9 12 5 9 5 1 10 6 3 10 6 9 13
5 3 9 12 14 12 6 10 6 3 9 5 3 9 12 12
12 7 2 8 5 10 5 3 1 11 6 2 11 12 12 12
4 9 13 12 12 5 10 13 6 9 5 1 3 10 12 12
14 12 6 10 12 12 5 8 5 10 12 14 5 9 6 8
5 8 5 3 10 12 14 12 12 5 10 5 10 12 5 10
12 14 6 9 13 12 5 8 12 6 3 10 5 8 12 13
12 5 9 12 6 2 10 14 6 3 1 9 12 12 6 8
4 10 12 6 9 5 1 3 3 3 8 14 12 6 11 12
6 9 6 9 12 12 14 5 9 5 10 5 8 5 3 10
13 6 9 6 10 12 5 10 12 6 9 12 14 6 9 13
4 3 10 7 3 2 10 5 10 5 10 6 9 5 10 12
6 3 3 3 3 3 3 10 7 2 3 11 6 2 3 10
