16
12 4
6 5
5 9 7 3 3 1 11 5 9 7 1 1 3 3 3 9
12 6 3 3 1 10 5 10 6 11 14 12 13 5 3 10
4 3 9 5 10 5 10 5 1 9 5 10 12 12 7 9
12 5 10 14 5 10 7 10 12 6 10 13 4 10 5 8
14 6 9 5 10 7 1 9 12 5 9 4 10 7 8 14
5 3 10 12 5 3 10 12 12 12 6 10 5 9 6 9
12 5 9 12 6 3 9 6 10 12 5 1 10 6 9 12
4 10 12 12 5 3 10 5 3 10 12 12 5 11 6 8
12 5 10 6 10 5 3 10 5 11 12 12 6 3 9 12
12 6 3 3 3 10 13 5 2 9 12 6 3 9 12 12
12 7 1 3 9 5 2 10 13 12 12 5 11 12 4 10
6 3 10 5 10 6 3 3 8 6 10 12 5 10 6 9
5 3 9 6 9 5 3 9 6 3 3 10 4 3 9 12
12 13 6 3 10 6 9 6 9 5 3 9 12 5 10 12
12 6 3 1 3 3 10 5 10 12 5 10 14 12 13 12
6 3 3 10 7 3 3 2 3 10 6 3 3 10 6 10
