16
9 8
7 3
13 5 1 3 11 13 7 3 1 9 5 3 3 9 5 9
12 12 6 3 3 10 5 3 10 6 10 5 9 6 10 12
12 6 3 3 9 5 10 7 3 9 5 10 6 1 11 12
4 3 3 11 6 10 5 1 3 10 6 3 9 6 9 12
12 5 9 5 3 1 10 12 5 3 3 9 6 9 6 10
6 10 6 2 9 12 5 10 6 9 13 6 3 10 5 11
5 9 5 9 14 12 6 9 5 10 4 3 3 3 2 9
12 6 10 6 3 10 5 10 12 7 2 9 5 3 3 8
4 3 3 3 9 13 6 9 12 5 9 14 12 7 9 12
6 9 13 5 10 4 3 10 6 10 6 9 4 9 4 10
13 4 10 6 9 12 5 3 3 3 3 10 12 12 12 13
12 12 5 3 10 14 6 9 7 1 3 9 14 12 6 8
4 10 6 9 5 1 11 6 3 10 13 6 3 10 5 10
14 5 3 10 12 6 9 5 3 3 0 3 3 11 6 9
5 10 5 3 10 13 6 10 5 9 6 9 5 9 5 10
6 3 2 3 3 2 3 3 10 6 11 6 10 6 2 11
