16
5 2
11 8
13 5 3 3 1 9 5 3 9 5 3 1 3 9 7 9
4 2 11 5 10 14 12 5 10 12 13 12 7 2 3 10
12 5 3 8 5 9 12 12 5 10 12 6 3 3 3 9
12 6 9 14 12 6 10 12 6 9 6 3 3 1 9 12
6 9 6 9 12 5 11 6 9 6 3 3 9 12 14 12
13 12 13 6 2 10 5 3 0 3 3 9 12 12 5 10
12 12 4 9 5 3 10 5 10 5 9 14 12 12 6 9
12 4 10 14 12 5 9 12 13 12 6 9 6 8 13 12
6 10 5 3 10 12 12 4 10 12 5 2 11 6 8 12
5 3 10 5 3 8 14 12 5 10 6 9 5 3 10 12
4 3 9 12 7 10 5 10 12 7 9 6 10 7 9 12
14 5 10 4 3 9 6 9 6 3 2 9 5 9 12 12
5 10 5 10 13 6 3 8 5 3 3 2 10 12 12 12
4 9 6 3 10 5 9 14 12 5 3 9 5 2 10 12
12 12 5 3 3 10 6 3 10 12 7 8 14 5 9 12
14 6 2 3 3 3 3 3 11 6 11 6 3 10 6 10
