16
13 14
0 9
13 5 3 1 9 5 3 3 1 3 3 3 3 9 5 9
6 2 11 12 12 14 5 9 6 9 5 3 9 12 12 12
5 9 5 10 6 3 10 12 5 10 12 5 10 6 8 12
12 6 10 5 3 1 11 12 12 5 10 6 3 9 14 12
4 9 5 10 7 10 5 10 14 6 9 5 11 6 9 12
14 12 4 9 5 3 10 5 3 9 12 6 1 11 12 12
5 10 12 6 10 7 1 10 5 10 12 5 8 5 10 12
12 7 2 9 5 9 12 13 6 3 10 12 14 6 9 12
4 9 13 12 12 6 10 4 1 11 5 2 1 9 6 8
14 12 12 12 4 9 5 10 6 3 10 5 10 6 11 12
5 10 4 10 12 12 6 3 3 9 13 6 3 3 3 10
12 13 12 13 12 12 7 1 9 6 8 7 1 3 3 9
12 4 10 6 10 6 9 12 12 5 2 3 10 5 11 12
12 4 3 3 3 3 10 12 6 2 11 7 9 4 9 12
12 14 5 3 9 5 9 6 11 5 3 3 10 12 6 10
6 3 2 11 6 10 6 3 3 10 7 3 3 2 3 11
