16
15 14
13 15
5 1 3 11 5 1 3 9 5 3 3 3 9 13 5 9
12 6 3 3 10 12 5 10 4 3 9 5 10 4 10 12
6 11 5 3 3 10 12 7 8 5 10 12 13 12 5 8
5 3 10 5 3 9 6 9 12 12 13 12 6 10 12 14
4 3 9 6 9 6 9 12 12 12 12 12 5 3 10 13
12 13 6 9 6 9 14 12 12 12 6 2 10 5 9 12
6 0 11 6 9 12 5 10 12 6 9 5 3 10 6 10
13 12 5 3 10 12 6 9 6 11 12 12 5 9 7 9
4 10 12 5 1 2 11 6 9 5 10 6 10 6 3 8
12 5 10 12 12 5 3 3 10 4 3 3 1 11 5 10
14 12 5 10 6 8 7 3 3 10 5 3 8 5 10 13
5 10 14 5 9 6 3 3 3 3 10 5 10 12 7 8
4 3 3 10 12 5 11 5 3 1 11 4 11 6 3 8
12 5 9 5 10 6 3 2 11 6 3 8 5 9 5 10
12 12 6 10 5 3 9 5 3 3 9 14 12 12 6 9
14 6 3 3 2 11 6 2 3 11 6 3 10 6 3 10
