16
7 1
13 12
7 1 9 5 9 7 3 1 9 5 11 5 3 3 1 9
5 10 4 10 6 9 5 10 12 6 1 2 11 5 10 12
4 9 14 5 9 12 4 9 6 9 14 5 3 10 13 12
12 6 3 10 12 12 14 12 7 2 3 10 13 5 2 10
12 5 9 5 10 6 9 6 1 9 5 3 10 6 9 13
6 10 12 6 3 9 6 9 14 12 4 3 3 9 12 12
7 3 2 3 11 12 13 12 5 10 12 5 9 12 6 8
5 3 3 3 9 12 4 2 10 5 10 12 12 6 3 10
6 3 9 5 10 12 14 5 9 6 9 14 6 3 3 9
5 1 10 6 3 10 5 10 12 13 6 3 9 5 9 12
12 12 5 3 3 3 10 5 10 4 3 9 12 12 6 8
12 14 6 3 9 5 11 12 5 8 7 10 12 12 13 12
4 3 1 9 12 12 5 10 12 14 5 9 12 12 4 10
6 9 12 12 6 8 12 13 4 3 10 6 2 10 12 13
13 12 12 6 11 12 12 6 10 5 3 3 9 13 12 12
6 10 6 3 3 10 6 3 3 2 3 11 14 6 2 10
