16
11 3
14 5
5 1 9 7 3 1 3 3 3 9 5 3 9 7 3 9
12 12 12 5 3 10 5 9 13 6 10 13 6 3 9 12
12 12 12 12 5 9 12 12 6 9 7 0 3 11 6 8
12 12 4 10 12 6 10 6 9 6 9 4 3 9 5 10
12 12 14 5 2 3 3 11 4 9 12 6 11 6 2 11
12 6 3 2 11 5 9 5 10 14 6 3 3 3 3 9
12 5 3 11 5 10 6 10 5 9 5 9 5 3 9 12
12 6 9 5 10 5 3 3 10 6 10 12 4 11 12 12
6 9 12 6 9 12 5 9 5 3 9 12 12 5 10 12
13 12 12 5 8 12 12 6 10 13 12 6 10 12 5 10
12 12 12 12 14 6 10 5 9 4 10 5 3 10 6 9
4 2 10 12 5 3 3 10 6 10 5 10 5 3 3 10
4 11 5 10 12 5 3 3 9 5 10 5 10 7 1 9
12 5 10 5 10 12 7 3 2 10 5 10 7 1 10 12
12 6 3 10 13 6 3 3 9 5 10 7 1 10 13 12
6 3 3 3 2 3 3 11 6 2 3 3 10 7 2 10
