16
10 1
3 14
5 1 9 7 9 5 3 9 5 3 3 9 5 3 3 9
12 12 6 3 10 12 5 10 6 1 9 6 10 7 3 8
14 12 5 3 3 10 6 3 9 14 6 1 9 5 9 12
5 8 12 7 3 3 3 9 6 3 9 12 6 10 12 14
12 14 12 5 3 3 9 6 9 5 10 12 5 9 6 9
4 3 10 6 3 9 6 9 6 10 7 2 10 14 5 8
12 7 1 3 9 12 5 2 3 9 5 9 5 3 10 12
12 5 10 7 10 12 6 3 9 12 12 6 10 13 5 10
12 12 5 3 3 10 13 5 10 6 10 13 5 8 12 13
12 6 8 7 1 3 8 6 3 9 13 4 10 6 10 12
6 9 6 3 10 7 2 11 5 10 4 10 7 3 1 8
13 6 3 3 3 3 3 9 12 7 2 3 3 9 14 12
4 1 9 7 1 9 13 12 6 3 1 9 7 2 9 12
14 12 6 3 10 12 12 12 5 9 14 6 3 9 6 8
5 10 7 3 3 2 10 12 12 12 5 3 9 6 9 12
6 3 3 3 3 3 3 2 10 6 10 7 2 3 10 14
