16
9 0
1 5
13 5 3 9 5 3 3 3 1 3 11 5 3 3 1 11
12 6 9 12 12 5 3 9 6 1 3 10 5 9 6 9
4 9 12 12 12 6 9 6 9 14 5 3 10 6 9 12
12 12 12 6 10 13 6 9 12 5 10 5 9 5 2 10
14 12 12 7 3 8 13 12 12 6 9 14 6 10 5 9
5 10 6 3 1 10 6 10 6 9 6 3 9 5 10 12
12 5 1 11 12 5 3 1 11 6 3 9 12 12 5 10
6 10 6 9 12 12 13 6 3 9 5 10 6 10 4 9
5 3 9 12 12 6 2 3 9 6 10 5 3 9 14 12
12 13 12 12 6 3 9 5 10 7 3 8 13 6 3 8
12 12 4 2 11 5 10 6 3 3 9 12 6 9 5 10
12 6 10 5 9 4 3 11 5 3 10 6 9 12 6 9
4 3 3 10 6 10 5 3 10 5 1 3 10 6 9 12
12 5 9 5 3 3 10 5 9 12 12 5 1 3 10 12
12 12 12 6 9 7 1 10 12 14 12 12 12 5 3 10
6 10 6 11 6 3 10 7 2 3 10 14 6 2 3 11
