16
3 4
1 1
5 11 5 3 3 9 5 3 1 11 5 3 3 1 3 11
6 9 12 5 3 8 12 13 6 3 10 7 9 6 3 9
5 10 12 6 9 14 6 8 7 1 9 5 8 5 9 12
4 3 10 13 6 3 9 6 3 10 12 12 14 12 6 8
12 7 3 2 1 9 6 9 5 3 2 8 5 10 13 12
6 3 3 9 14 4 9 6 10 5 9 14 12 5 2 10
5 9 13 6 9 12 4 3 11 12 12 5 10 12 5 11
12 6 10 5 10 12 12 5 3 10 6 10 13 12 4 9
4 3 9 12 5 10 14 6 9 5 3 9 12 12 14 12
6 9 6 10 4 3 3 9 6 10 5 10 12 6 9 12
5 10 5 11 6 9 5 2 9 5 10 13 4 3 10 12
12 5 10 5 9 12 6 9 14 12 5 10 6 3 3 8
12 6 3 10 6 2 11 12 5 10 4 3 9 5 3 10
12 5 3 3 3 3 3 8 6 9 6 9 12 6 3 9
12 12 7 3 3 3 9 6 11 12 5 10 6 1 11 12
6 2 3 3 3 11 6 3 3 10 6 3 11 6 3 10
