16
15 12
1 13
5 1 11 5 3 3 3 1 9 5 3 3 3 3 9 13
12 14 5 10 7 9 5 10 6 8 5 3 3 9 12 12
6 9 6 3 3 8 6 9 13 12 6 1 11 12 12 12
5 2 3 9 13 6 9 12 6 2 11 12 5 10 6 8
12 7 9 6 2 9 12 12 5 9 5 10 12 5 9 12
4 9 4 3 9 12 12 6 10 12 12 5 10 14 12 12
12 12 6 9 6 10 6 9 13 6 10 6 3 9 6 8
12 12 13 12 5 9 13 12 6 1 3 1 11 6 9 12
12 12 12 12 12 6 8 6 9 6 11 12 5 3 10 14
12 12 6 2 10 7 2 11 12 5 3 8 6 3 3 9
12 6 3 3 3 3 3 3 8 12 5 10 5 3 9 12
12 7 3 9 5 3 3 9 6 10 14 5 10 13 12 12
6 3 9 12 12 5 3 2 3 3 9 12 7 0 10 12
5 3 2 10 12 12 7 3 9 13 12 6 9 6 3 8
12 7 9 5 10 14 5 9 12 12 6 9 6 9 5 10
6 3 10 6 3 3 10 6 10 6 3 2 3 10 6 11
