16
14 11
7 15
5 3 1 3 11 5 3 3 9 5 3 3 1 9 5 9
4 9 12 5 3 10 13 5 10 12 7 9 12 6 10 12
12 12 14 12 5 3 8 12 7 2 3 10 12 5 3 10
12 6 9 12 12 7 10 6 3 9 5 9 12 6 9 13
14 5 8 12 6 3 1 9 13 6 10 12 12 5 2 10
5 10 12 6 3 9 12 6 8 5 11 12 12 14 5 9
12 7 2 9 7 10 4 9 6 10 5 10 4 3 10 12
4 9 13 12 7 9 12 6 3 3 10 13 12 5 3 8
12 12 12 12 5 8 12 7 9 5 3 8 12 6 9 12
12 12 6 2 8 14 6 9 4 10 13 6 10 5 10 12
12 6 9 13 12 5 3 10 6 3 10 5 9 6 9 12
12 13 12 6 10 6 9 7 1 3 9 12 6 9 12 12
6 8 6 3 1 11 6 9 12 5 10 12 5 10 12 14
13 6 3 9 12 5 9 6 10 12 7 8 6 9 6 9
4 3 9 12 12 12 6 1 11 6 3 10 5 10 5 8
6 11 6 10 6 2 11 6 3 3 3 3 2 3 10 14
