16
10 9
3 7
7 3 3 1 9 7 1 3 1 9 13 5 9 5 3 9
5 3 3 10 6 9 6 9 12 12 6 8 12 12 13 12
6 9 5 9 7 8 7 10 12 6 9 14 6 2 10 12
5 8 12 6 9 6 3 3 10 13 12 5 3 9 5 8
12 14 6 9 12 5 3 3 1 8 12 12 5 10 12 14
4 3 9 12 12 12 5 9 14 12 12 12 12 7 2 9
12 5 10 12 12 14 12 6 9 4 10 12 6 3 3 8
12 6 3 10 6 3 2 11 12 6 9 6 3 9 13 12
6 9 13 5 1 3 9 5 10 5 10 5 3 10 12 12
13 12 6 10 12 5 10 12 13 6 9 12 13 5 2 10
12 12 5 9 12 14 5 10 4 11 12 12 6 2 3 9
12 6 10 6 8 5 10 7 8 5 10 6 9 7 9 12
4 3 9 5 10 6 3 9 12 12 7 1 0 11 12 12
6 9 6 10 7 9 5 10 6 2 3 10 14 5 10 12
5 10 7 3 1 8 6 3 3 3 3 3 9 6 9 12
6 3 3 3 10 6 3 3 3 3 3 11 6 3 10 14
