16
1 7
12 4
7 9 5 1 11 5 3 1 9 7 1 9 7 1 9 13
5 10 12 6 3 10 5 10 6 9 12 6 3 10 6 8
4 9 12 7 9 5 10 5 3 10 6 1 9 7 9 12
12 6 2 3 10 12 5 10 7 1 9 12 12 5 10 12
14 5 3 3 9 12 12 5 9 12 12 14 12 12 5 10
5 10 7 1 2 10 6 10 6 10 6 9 12 12 6 9
12 5 9 14 5 3 3 3 3 9 13 6 10 12 5 10
12 12 12 7 10 5 3 11 5 10 4 3 3 10 12 13
12 12 6 3 3 8 5 3 10 7 0 3 3 3 10 12
12 6 9 7 9 6 10 5 3 9 12 5 3 3 3 8
12 5 10 5 2 9 5 10 5 10 6 10 5 3 3 10
12 6 3 10 13 6 10 5 10 5 11 5 10 5 3 9
4 3 3 3 8 7 9 12 13 4 3 10 5 2 9 12
4 3 3 9 6 3 8 12 12 6 3 9 12 5 10 12
12 7 9 12 5 9 14 12 4 3 9 12 14 12 5 10
6 3 10 6 10 6 3 10 6 11 6 2 3 10 6 11
