16
3 13
12 13
5 9 5 3 9 5 3 3 3 1 9 13 5 1 3 9
12 12 12 13 12 4 11 5 9 12 6 10 12 6 9 12
12 6 10 12 6 10 5 10 6 10 5 3 2 9 12 12
6 9 5 8 5 9 6 3 3 9 6 9 13 12 12 14
13 12 12 6 8 6 3 9 13 12 5 10 12 14 6 9
4 10 6 9 14 5 9 6 10 12 12 13 6 3 9 12
6 9 5 10 5 10 12 5 9 12 6 2 3 9 6 10
13 12 6 9 12 13 12 12 12 6 1 11 5 10 7 9
12 6 9 4 2 10 6 10 4 11 6 3 10 5 1 10
4 3 10 12 13 5 3 9 4 3 3 3 3 10 6 9
12 7 1 10 12 12 13 12 6 9 5 9 5 3 3 8
6 9 12 5 8 12 4 10 5 10 12 12 12 7 1 10
13 12 6 8 14 12 6 9 12 13 12 12 6 9 12 13
12 12 7 10 5 10 13 12 4 10 12 12 5 10 6 8
4 10 5 3 10 13 4 10 14 5 10 12 12 5 3 10
6 3 10 7 3 2 2 3 3 10 7 2 10 6 3 11
