16
15 15
4 3
5 9 5 1 3 3 9 5 3 3 9 7 3 3 3 9
12 12 12 6 9 5 2 10 5 9 6 9 5 3 9 12
12 6 10 13 12 12 13 5 10 12 7 2 10 13 12 12
6 3 3 8 12 12 12 12 13 6 3 9 5 10 6 8
5 3 9 14 12 12 12 12 4 3 11 12 12 5 9 12
12 7 2 3 10 4 10 6 8 5 3 8 6 10 6 10
12 5 9 7 3 10 5 9 12 12 13 12 5 3 3 9
6 10 6 3 9 5 10 6 10 12 4 10 6 3 9 12
5 3 1 3 10 6 3 9 13 12 14 5 3 3 10 12
4 9 14 5 1 11 5 2 10 12 5 10 5 9 5 10
12 6 3 10 6 3 2 11 5 10 12 7 10 12 6 9
12 13 5 3 9 5 3 3 8 5 10 5 3 10 5 10
12 6 8 5 10 12 5 3 10 14 5 10 5 3 10 13
6 9 12 12 5 10 12 7 1 3 10 5 10 5 1 8
13 12 14 12 6 9 6 3 10 5 9 6 9 14 12 12
6 2 3 2 11 6 3 3 3 10 6 3 2 3 10 14
