16
14 8
5 13
5 3 3 1 3 3 3 1 3 3 9 5 1 3 3 9
12 5 9 12 7 3 3 8 5 9 14 12 12 7 3 10
14 12 12 12 5 3 9 14 12 12 5 10 6 9 5 9
5 10 12 6 2 9 6 3 10 6 2 3 11 4 10 12
12 13 6 3 9 6 3 3 3 11 5 3 9 6 11 12
12 6 3 3 2 1 3 3 3 3 10 13 6 3 3 8
4 9 5 3 9 14 5 9 7 1 3 2 3 9 5 10
14 12 6 9 6 1 10 6 9 6 9 7 9 12 12 13
5 2 11 6 9 14 13 13 6 9 6 9 12 6 10 12
12 5 3 9 6 3 10 4 3 10 13 12 4 3 3 8
4 2 11 4 3 3 9 6 3 9 4 10 6 9 5 10
4 11 5 10 13 5 10 13 5 10 6 9 5 10 12 13
14 5 10 7 2 2 1 10 6 9 13 6 10 13 6 8
5 10 5 3 3 9 14 5 3 10 4 3 1 2 11 12
4 3 10 5 9 12 5 10 5 11 12 5 10 5 9 12
6 3 3 10 14 6 10 7 2 3 10 6 3 10 6 10
