16
0 10
13 6
5 3 3 3 3 3 3 3 1 11 5 1 9 7 3 9
12 7 1 9 5 3 9 13 4 3 10 12 12 5 3 8
6 1 10 14 12 13 6 10 6 9 5 10 6 10 13 12
13 12 5 3 10 6 3 1 9 14 12 5 9 5 2 10
4 10 6 3 3 3 9 12 12 5 10 14 12 12 5 9
6 9 5 3 9 13 6 10 12 6 3 9 6 10 12 12
5 10 12 13 12 6 3 9 6 9 5 10 5 3 10 12
6 3 10 4 10 5 3 8 13 12 4 3 2 11 5 8
13 5 9 6 9 12 13 6 8 12 6 9 5 9 12 12
12 12 6 9 6 10 4 3 10 12 5 10 12 6 10 12
12 6 9 12 5 3 10 5 3 10 14 5 10 5 3 10
4 9 12 6 10 5 3 10 5 3 1 10 13 6 9 13
12 6 10 5 9 6 9 13 12 13 6 9 4 9 12 12
12 5 3 10 6 3 10 4 2 10 5 10 12 14 6 8
12 12 5 3 9 7 3 10 5 9 12 13 4 3 3 10
14 6 10 7 2 3 3 3 10 6 10 6 2 3 3 11
