16
4 11
3 1
5 3 1 9 13 5 3 3 1 9 5 9 5 3 3 9
12 13 12 6 10 12 5 3 10 6 8 6 10 7 1 10
6 8 6 3 9 12 12 5 3 9 12 5 3 9 6 9
13 12 5 9 6 10 12 12 7 10 12 6 9 6 9 14
12 6 10 6 9 5 10 4 3 9 12 13 12 13 6 9
12 5 3 9 12 6 9 12 5 8 6 8 6 8 13 12
12 6 9 6 10 5 10 12 12 14 5 10 5 2 10 12
4 3 10 7 9 6 9 12 6 3 8 5 10 13 5 10
12 7 3 1 8 13 12 12 5 9 14 12 7 8 6 9
12 5 3 10 6 8 12 12 12 6 3 10 5 8 13 14
12 12 5 11 5 10 12 14 12 13 5 3 8 6 2 9
12 12 12 5 10 13 6 9 12 6 2 9 12 5 3 10
6 10 4 2 3 10 5 8 6 9 7 10 12 6 3 9
5 11 6 9 5 3 10 6 9 6 3 9 4 9 13 12
4 9 5 10 12 5 3 9 6 11 5 10 14 12 12 12
14 6 2 11 6 2 11 6 3 3 2 3 3 10 6 10
