16
9 14
15 2
5 9 5 3 3 9 5 3 1 9 5 9 5 1 9 13
12 6 10 5 11 6 10 5 10 6 10 12 12 12 6 8
12 7 9 4 1 9 13 6 3 9 5 10 12 12 13 12
6 9 4 10 12 12 6 9 5 10 6 9 12 12 6 8
5 10 12 5 10 6 1 10 6 3 9 12 14 4 9 12
6 9 12 6 9 5 10 5 3 3 10 6 9 14 12 12
13 12 4 11 12 12 13 6 9 7 1 3 2 3 10 12
12 12 14 5 10 12 6 9 6 9 14 5 3 9 5 10
12 6 9 12 13 12 5 2 11 12 13 12 13 12 6 9
12 5 10 12 12 4 10 5 9 12 6 10 12 6 9 12
4 10 7 8 4 10 5 10 6 8 7 9 4 9 12 12
6 3 3 10 6 9 12 7 3 8 5 10 12 6 10 12
5 3 1 3 11 12 6 3 9 12 6 9 6 9 5 10
6 9 12 5 3 10 7 9 12 6 3 2 11 12 12 13
5 10 6 10 7 1 3 8 6 9 5 3 9 12 12 12
6 3 3 3 3 10 7 2 11 6 2 11 6 10 6 10
