16
15 1
5 5
13 5 3 3 3 3 3 3 9 5 3 3 1 3 9 13
4 10 13 5 1 9 5 3 8 12 5 9 12 13 6 8
6 9 12 12 12 14 12 5 10 6 10 12 12 12 5 10
13 12 6 10 12 5 10 14 5 3 9 12 12 12 6 9
12 6 9 5 8 6 3 3 10 13 6 10 12 4 3 10
4 3 2 10 6 3 3 9 7 0 3 11 12 6 9 13
6 11 5 3 9 7 3 2 3 10 5 9 6 9 6 8
5 3 10 5 10 5 3 3 9 5 10 12 5 10 5 10
12 7 9 12 5 8 13 5 10 12 13 6 10 13 12 13
12 5 10 12 12 12 12 12 5 10 6 1 3 2 8 12
12 6 3 10 14 12 12 12 6 3 9 14 5 9 6 10
12 7 3 1 3 10 12 6 9 5 8 5 10 6 3 9
12 5 3 10 5 9 4 3 10 12 14 6 3 1 11 12
12 12 13 5 10 12 6 9 7 2 3 3 3 10 5 8
6 10 4 10 13 4 11 6 3 3 3 3 3 9 12 12
7 3 2 3 10 6 3 3 3 3 3 3 3 2 10 14
