16
2 15
1 13
5 1 9 7 3 1 9 5 1 11 5 3 3 1 3 9
12 12 6 3 3 10 12 12 12 5 10 5 11 12 7 8
12 12 7 3 3 9 12 12 6 2 11 12 7 2 9 14
12 6 3 3 9 12 12 6 9 13 5 10 5 9 6 9
12 7 1 11 12 6 2 11 6 8 12 7 8 6 9 12
6 3 8 5 10 5 3 1 9 12 6 9 12 7 2 10
13 5 10 6 3 10 5 10 12 12 5 10 12 5 3 9
12 12 5 9 5 9 12 5 10 12 12 13 4 10 5 8
12 6 10 12 12 12 12 14 5 10 12 6 8 13 12 12
12 5 3 10 12 14 12 5 2 11 6 9 12 12 12 12
12 6 9 7 2 9 6 10 13 5 3 10 4 10 12 12
4 9 12 5 9 4 3 1 8 12 13 5 10 5 10 12
14 12 6 10 12 12 5 10 14 12 6 10 5 10 7 8
5 2 3 9 12 14 6 9 5 10 5 9 4 3 9 14
4 9 7 10 6 3 3 8 6 3 10 12 6 11 6 9
14 6 3 3 3 3 3 2 3 3 11 6 3 3 3 10
