16
1 5
7 1
5 9 13 5 3 3 9 5 3 3 11 5 3 9 5 9
12 6 10 4 9 7 8 4 3 3 3 2 11 6 10 12
12 5 9 14 6 9 12 14 5 3 3 3 9 5 9 12
12 12 6 3 3 10 6 3 10 5 3 9 12 12 12 12
12 12 5 3 1 3 9 7 3 2 9 14 12 12 12 12
12 12 12 5 10 7 2 3 3 9 4 9 6 10 6 8
12 14 14 6 1 3 9 5 3 10 14 4 9 13 5 10
6 1 3 9 6 11 12 12 7 1 9 12 6 10 12 13
5 10 13 6 9 5 10 6 1 10 6 8 5 9 6 8
12 7 2 9 4 10 7 3 10 5 9 14 12 12 5 10
6 3 9 6 10 5 3 3 3 10 12 5 10 6 10 13
5 3 8 5 9 6 9 5 9 13 6 10 5 3 3 8
12 5 10 12 6 9 6 10 12 6 3 1 10 5 9 12
12 14 5 2 11 4 1 11 6 3 9 4 9 12 12 12
4 9 12 13 5 10 14 5 3 9 12 14 6 10 12 12
14 6 2 10 6 3 3 2 11 6 2 3 3 3 10 14
