16
11 1
3 3
13 5 9 5 1 11 5 1 9 5 3 3 1 9 5 9
12 12 6 10 6 3 10 12 12 6 9 5 10 12 14 12
4 10 5 3 9 5 3 10 6 11 12 12 13 12 5 8
4 11 12 13 12 6 3 3 3 3 10 12 12 12 12 12
12 5 10 4 10 5 3 3 3 9 5 10 6 2 10 12
14 12 13 6 3 10 13 5 3 10 12 5 3 9 5 10
5 10 4 3 3 3 8 6 3 9 12 6 9 12 12 13
6 9 12 7 3 9 4 11 5 10 4 3 10 12 6 8
5 10 6 3 3 8 6 9 6 9 6 11 5 10 13 12
6 3 9 5 11 12 13 6 9 12 5 9 12 7 2 8
5 9 12 6 3 0 2 11 12 6 10 12 6 1 9 14
12 6 10 5 9 12 5 9 4 1 11 6 9 12 6 9
12 5 11 12 12 14 12 12 12 14 5 3 10 4 11 12
6 10 5 10 6 3 8 6 10 5 10 5 9 14 5 8
5 3 8 5 3 9 14 5 3 10 5 10 12 5 10 12
6 11 6 2 11 6 3 2 3 3 10 7 2 10 7 10
