16
14 0
12 10
5 3 9 5 3 9 5 3 3 3 3 1 3 3 3 9
4 11 6 2 11 12 12 7 1 1 11 12 13 5 3 10
12 7 3 9 5 10 6 3 10 12 5 10 12 6 3 9
6 9 13 6 10 5 3 3 3 10 12 5 2 11 5 10
13 12 4 1 9 14 5 3 3 3 10 4 3 3 10 13
4 10 12 12 6 3 10 5 3 1 11 6 9 5 9 12
12 7 10 6 9 5 11 6 9 6 9 5 10 12 6 8
6 9 5 9 12 6 3 9 4 11 12 12 5 2 9 14
5 10 12 6 8 5 9 12 12 5 10 12 6 9 6 9
6 9 12 7 8 12 12 4 10 6 9 6 9 12 13 12
5 10 4 9 14 12 12 6 3 9 6 3 10 6 10 12
12 13 12 6 3 10 6 9 13 12 5 9 5 3 3 8
12 6 2 11 5 9 5 10 12 12 12 6 10 13 5 10
12 5 3 3 10 6 10 5 8 12 6 3 9 4 10 13
12 12 5 9 5 3 3 10 6 10 5 9 12 6 9 12
6 10 14 6 2 3 3 3 3 3 10 6 10 7 2 10
