16
10 10
13 11
13 5 3 1 3 1 11 5 11 5 1 9 7 3 1 11
12 12 13 6 9 14 5 10 7 8 12 6 3 9 6 9
4 10 4 11 6 9 12 5 9 14 6 9 13 6 3 8
6 1 10 5 3 8 6 10 6 3 3 10 4 3 3 10
5 10 5 8 7 10 5 3 3 3 1 9 6 9 7 9
6 11 12 14 5 3 10 5 11 5 10 6 11 12 5 10
5 9 12 5 10 5 3 10 5 10 5 3 3 10 4 9
12 6 10 12 13 4 3 9 6 9 12 5 9 7 8 12
4 3 9 12 12 12 13 4 11 12 6 10 6 9 14 12
12 13 12 12 6 2 10 6 9 4 11 5 3 10 5 8
12 12 6 10 5 3 3 9 12 12 5 10 5 3 10 14
12 6 1 3 8 5 11 12 12 12 12 5 8 5 3 9
6 9 12 5 10 12 5 10 12 6 10 14 6 10 5 8
13 12 14 6 9 4 10 5 8 7 1 9 5 3 10 12
12 6 3 3 10 6 3 10 6 3 10 6 10 13 5 10
6 3 3 3 3 3 3 3 3 3 3 3 3 2 2 11
