16
13 7
4 8
5 1 9 7 3 3 3 1 3 9 5 3 3 3 3 9
12 12 6 3 3 3 9 6 11 12 6 1 11 5 9 12
14 6 3 9 13 5 10 5 9 6 3 10 5 10 12 12
5 3 3 10 6 8 5 10 6 3 3 3 10 5 10 12
12 5 3 3 9 12 6 3 3 9 5 3 11 12 5 8
4 10 5 3 10 6 3 3 9 12 12 5 3 10 14 12
6 11 12 5 11 5 1 11 12 12 4 10 5 3 3 8
5 3 10 4 3 10 6 3 2 10 12 5 10 5 9 12
12 7 1 10 5 9 5 11 5 9 6 10 7 8 6 10
6 9 12 5 8 6 10 5 10 12 5 3 9 6 9 13
5 10 12 12 14 5 9 12 7 8 6 9 6 9 12 12
12 7 2 8 5 10 12 6 11 6 3 10 13 12 6 8
6 3 9 14 12 5 0 3 3 3 9 5 8 12 5 10
5 3 10 5 10 12 12 5 3 9 14 12 6 10 12 13
4 9 5 10 5 10 14 6 9 12 5 10 5 11 12 12
14 6 2 11 6 3 3 3 10 6 10 7 2 3 2 10
