16
14 0
8 15
5 1 3 1 3 3 3 3 9 7 3 1 3 3 3 9
14 6 9 14 5 3 9 13 12 5 9 6 9 5 3 10
5 9 4 3 10 13 12 4 10 12 6 3 10 12 5 9
12 12 6 3 3 8 12 6 3 10 5 9 13 12 14 12
12 6 9 7 3 10 12 5 9 5 10 12 12 6 3 8
6 9 6 3 3 9 12 12 6 10 13 6 0 3 11 12
5 10 7 1 11 12 12 12 7 3 2 9 12 5 3 10
6 3 9 12 5 10 12 6 3 3 9 6 8 6 9 13
5 11 12 12 12 7 0 3 3 9 6 9 14 5 10 12
12 5 2 10 6 9 6 9 13 6 9 12 5 10 5 8
12 6 9 5 3 10 7 2 0 11 12 6 2 3 10 12
12 5 10 6 3 9 5 9 14 5 10 5 9 5 9 14
12 6 9 5 11 12 12 6 9 4 9 12 6 10 6 9
12 5 10 6 9 6 10 13 12 14 6 10 5 3 3 8
4 10 5 3 2 9 7 8 6 11 5 9 6 9 13 12
6 3 10 7 3 2 3 2 3 3 10 6 3 10 6 10
