16
0 0
13 7
13 5 3 3 3 1 1 3 3 11 5 9 5 3 3 9
12 12 5 9 5 10 14 5 3 3 10 6 10 5 9 12
4 10 14 12 6 3 3 10 7 3 3 3 9 12 6 8
12 5 3 8 7 1 3 3 9 5 3 9 12 12 7 10
6 10 5 10 5 10 5 3 10 12 7 2 8 6 3 9
5 9 12 5 10 5 10 5 11 4 3 9 14 7 9 12
12 14 6 10 5 10 13 4 3 10 13 6 3 9 6 10
12 5 9 5 10 5 10 6 3 9 4 3 11 4 3 9
6 10 12 12 7 2 1 1 11 6 8 5 9 12 5 8
5 3 8 12 5 9 12 6 1 9 12 12 12 14 12 12
4 9 12 6 10 12 6 9 12 14 12 12 6 9 12 14
12 12 14 5 3 10 5 10 6 9 12 12 5 10 6 9
12 6 9 12 7 3 10 5 9 6 10 12 12 5 9 12
12 5 10 12 5 3 3 10 12 5 3 10 12 12 6 8
12 6 3 10 6 9 13 5 10 6 9 13 6 10 5 10
6 3 3 3 3 10 6 2 3 3 10 6 3 3 2 11
