16
0 0
9 10
7 1 9 5 3 3 9 5 3 3 9 5 3 1 3 11
5 10 12 6 9 7 10 4 3 11 6 2 11 4 3 9
12 5 2 3 10 5 3 10 5 3 9 7 9 6 11 12
12 14 5 3 3 10 5 11 6 9 6 3 10 5 9 12
12 5 10 5 9 7 8 5 9 12 7 3 1 10 6 10
12 12 5 10 6 9 12 12 12 12 5 9 12 5 3 9
4 10 6 9 5 10 6 10 12 6 10 6 10 12 5 10
12 7 1 10 6 3 9 5 2 9 7 3 3 10 6 9
6 3 10 13 5 9 6 10 13 6 3 9 5 9 5 8
7 1 9 12 12 4 3 1 10 5 9 12 12 12 12 14
5 10 6 8 12 6 9 12 5 10 12 6 10 12 6 9
12 5 9 12 4 11 12 14 12 13 6 3 3 10 5 8
4 10 12 14 12 5 10 5 10 4 3 3 3 1 10 12
12 13 12 5 10 12 5 10 7 2 3 3 11 4 9 14
12 12 6 10 13 12 6 9 5 9 5 3 9 14 6 9
6 2 3 3 10 6 3 2 10 6 10 7 2 3 3 10
