16
0 10
7 0
5 3 1 3 3 1 3 3 3 9 5 3 3 3 3 9
12 13 12 5 9 14 5 9 7 10 12 7 3 1 9 12
4 10 12 12 6 3 10 6 3 3 10 5 3 10 12 12
12 5 10 6 3 3 9 7 3 1 9 4 9 7 8 12
12 6 3 3 1 11 12 5 3 10 12 14 4 9 12 12
12 7 3 9 6 3 10 12 7 9 6 9 14 12 14 12
12 5 9 6 1 1 3 10 5 2 11 6 3 8 5 8
6 10 12 5 10 12 5 9 4 3 9 5 9 12 12 12
13 7 2 10 7 8 12 12 6 9 6 10 6 8 12 14
6 3 3 3 9 12 12 6 9 6 11 5 9 12 6 9
5 3 11 5 10 12 6 9 6 3 3 10 12 6 11 12
4 9 5 10 7 8 5 10 13 5 3 9 12 5 3 8
12 12 12 5 9 12 12 5 10 12 13 12 6 10 5 10
14 12 6 10 12 12 12 6 9 6 8 4 9 13 12 13
5 2 3 11 12 14 6 9 12 5 10 12 6 10 6 8
6 3 3 3 2 3 3 10 6 2 11 6 3 3 3 10
