16
9 1
0 4
13 5 3 3 1 1 3 11 5 9 5 1 3 9 5 9
12 12 7 9 12 14 5 3 10 12 12 6 9 6 10 12
12 12 5 8 6 3 2 11 5 10 4 11 6 9 13 12
12 6 10 6 3 3 9 5 10 5 10 5 9 12 6 10
12 5 3 9 5 9 12 12 5 10 13 12 6 10 5 9
6 10 5 10 12 12 12 12 12 5 8 6 9 5 10 12
5 3 10 5 10 6 10 6 2 8 6 11 6 2 9 12
12 5 9 12 7 9 7 9 7 8 5 3 9 13 12 12
6 10 6 2 3 2 11 6 9 12 12 13 12 12 12 12
5 9 5 3 3 9 5 3 10 14 12 6 8 6 10 12
12 6 10 5 9 6 10 7 1 9 6 9 4 3 3 10
6 3 9 14 4 1 3 9 12 6 3 10 14 5 3 9
5 9 6 9 14 6 9 6 10 5 3 3 3 2 11 12
12 6 9 12 5 9 4 3 3 8 13 5 3 3 3 8
12 13 12 12 12 12 14 5 9 6 10 6 3 3 9 12
6 10 6 2 10 6 3 10 6 3 3 3 3 3 10 14
