16
8 7
15 13
5 3 1 11 5 1 11 5 3 3 9 5 3 3 1 9
12 13 6 3 10 6 9 6 1 11 6 2 11 5 10 12
6 2 9 13 5 9 6 9 12 5 3 3 3 10 5 10
13 5 2 10 12 6 9 6 8 6 9 7 3 3 2 9
12 6 9 5 10 13 6 9 6 11 6 3 3 9 7 10
12 5 10 6 9 4 3 10 5 9 5 3 3 10 5 9
12 6 3 9 12 6 3 9 12 12 4 3 3 3 10 12
4 3 3 10 12 5 9 6 10 12 6 9 5 3 9 12
12 5 11 5 8 12 6 9 7 2 9 4 10 7 10 12
4 10 5 10 12 12 7 2 3 9 12 14 5 3 9 12
12 5 10 13 12 6 3 3 9 12 6 3 10 5 10 12
12 6 9 4 10 13 5 3 10 6 3 9 5 10 5 8
12 5 10 4 3 10 6 9 7 1 9 12 12 7 8 12
12 6 9 12 5 3 9 12 13 12 14 12 6 9 12 14
12 13 12 14 6 9 12 6 10 4 3 10 13 12 6 9
6 10 6 3 3 10 6 3 3 10 7 3 2 2 3 10
