16
11 5
4 6
5 3 1 9 5 3 3 9 7 9 5 3 1 9 5 9
12 5 10 6 10 7 9 12 5 10 6 9 12 12 14 12
12 6 3 3 9 5 8 12 6 3 3 10 12 6 3 8
4 11 5 9 12 12 14 6 3 3 3 9 6 9 5 10
12 5 10 6 10 6 3 3 1 9 13 6 3 10 12 13
14 12 5 1 3 3 3 9 12 12 6 3 1 11 12 12
7 10 12 6 3 9 7 2 10 6 3 1 10 5 10 12
13 5 10 5 11 6 3 9 5 9 5 10 5 10 7 8
4 10 5 8 5 3 9 12 12 6 2 11 6 9 5 8
6 9 14 12 12 7 2 10 12 5 11 5 9 6 10 12
5 10 5 8 6 3 9 7 2 10 5 10 6 3 3 10
6 3 10 6 3 9 6 3 3 3 10 5 3 3 3 9
5 3 1 9 5 10 5 9 5 3 3 8 5 9 5 8
12 13 12 14 6 9 12 12 12 5 9 6 10 14 12 12
6 8 6 1 11 12 12 12 14 12 6 3 3 9 12 12
7 2 11 6 3 2 10 6 3 10 7 3 3 2 10 14
