16
9 13
7 9
7 3 3 1 3 3 1 3 9 5 3 1 11 5 1 11
5 3 9 6 3 11 6 9 12 12 5 10 5 10 6 9
12 13 6 3 3 3 3 10 12 12 6 9 12 7 9 12
12 6 3 3 1 1 11 5 10 14 5 8 6 3 8 12
6 9 5 3 10 12 5 10 5 3 8 6 11 5 10 12
5 10 12 7 3 10 12 7 2 9 14 5 9 12 5 10
12 5 2 9 5 3 10 5 9 4 9 12 12 12 6 9
12 14 5 10 12 5 3 10 12 14 6 8 6 10 5 8
6 9 4 3 2 10 7 3 8 5 9 6 3 11 12 12
5 10 6 11 5 9 5 9 6 10 6 9 5 3 10 14
4 9 5 3 10 6 10 6 3 3 9 12 6 9 5 9
14 6 2 3 3 9 5 3 3 3 10 6 9 6 10 12
5 3 3 3 9 14 12 5 9 5 3 9 6 9 5 8
12 7 1 9 12 5 10 12 6 10 7 2 9 6 10 12
6 11 12 12 12 12 5 2 9 5 9 7 10 5 9 12
7 3 10 6 2 10 6 11 6 10 6 3 3 10 6 10
