16
6 7
0 4
5 1 9 7 3 1 9 5 3 3 1 3 3 9 5 11
14 12 6 3 9 14 12 12 5 9 6 9 5 10 6 9
13 6 9 7 2 3 10 12 12 6 3 10 12 5 3 8
6 9 6 1 3 3 3 10 12 13 5 9 12 6 9 12
13 6 9 12 5 1 9 13 12 12 12 12 6 9 12 12
4 11 12 12 14 12 6 8 12 6 10 4 9 12 12 12
4 3 10 12 5 10 7 10 6 3 9 12 14 6 10 12
12 7 3 2 10 5 3 3 3 9 12 6 3 1 11 12
12 5 3 3 3 8 5 3 9 6 10 5 3 8 5 10
12 12 5 9 7 10 12 13 6 9 7 8 5 10 6 9
12 6 10 6 3 3 2 2 11 6 9 12 6 3 9 12
6 3 9 5 3 3 3 3 3 3 10 4 9 7 10 12
5 11 12 12 5 11 5 1 1 3 11 12 6 3 3 10
12 5 10 12 12 5 10 12 12 5 3 10 7 1 9 13
4 10 7 8 4 10 13 12 14 12 7 1 3 10 12 12
6 3 3 10 6 3 10 6 3 2 3 10 7 3 2 10
