16
9 13
4 7
5 3 9 7 1 3 3 3 3 9 5 9 7 3 1 9
4 9 6 9 6 9 5 9 13 6 10 6 3 9 14 12
14 6 9 12 5 10 12 6 8 13 5 9 5 10 5 10
5 9 12 12 12 5 10 13 6 8 12 6 10 7 2 9
12 6 10 6 10 12 7 2 3 8 6 9 5 3 3 8
12 7 3 3 1 10 5 3 9 14 5 10 6 3 9 12
4 3 3 9 12 5 10 13 6 9 12 7 1 3 10 12
12 5 3 10 6 2 3 8 5 10 12 5 10 5 11 12
12 6 9 5 9 5 9 12 6 3 10 6 9 12 5 10
14 5 10 12 14 12 12 12 7 1 9 5 10 4 10 13
5 8 5 10 5 10 14 6 9 12 6 10 5 10 5 8
12 14 6 9 12 5 1 11 6 10 13 5 10 7 10 12
12 5 3 10 6 10 6 1 3 9 4 10 5 1 3 8
12 6 3 9 5 3 1 10 7 10 6 9 12 6 9 12
4 11 5 10 12 7 10 5 3 3 3 10 14 5 10 12
6 3 10 7 2 3 3 2 3 3 3 3 3 10 7 10
