16
7 7
14 4
13 5 1 3 3 9 5 3 3 3 3 3 3 3 9 13
12 12 6 3 9 12 6 1 3 3 3 1 9 7 2 8
4 10 5 3 10 6 9 6 11 5 9 14 4 3 9 12
12 5 10 5 11 5 10 5 3 10 6 9 12 5 10 12
12 12 13 4 9 6 9 6 3 9 5 10 12 12 5 10
14 12 12 12 6 9 6 3 9 12 12 7 10 12 12 13
5 10 12 12 5 2 3 9 6 10 12 5 9 12 6 10
12 7 8 12 6 3 9 6 9 5 10 12 12 6 3 9
12 13 4 10 7 9 6 9 14 12 5 10 6 3 9 12
12 12 12 7 1 2 11 6 9 12 12 5 1 9 12 12
6 10 6 3 10 5 3 3 8 6 10 14 12 12 12 12
5 3 3 3 3 10 13 5 2 3 9 5 10 14 6 8
4 9 7 1 3 3 2 10 5 9 4 10 5 3 3 10
12 6 9 12 5 9 5 9 12 12 12 5 10 13 5 9
6 9 12 14 12 12 12 6 10 12 14 12 7 2 10 12
7 10 6 3 10 6 2 3 11 6 3 2 3 3 3 10
