16
15 14
9 3
5 3 3 3 3 9 7 3 3 3 3 1 1 3 3 9
6 3 3 3 9 12 5 3 3 3 9 12 6 3 9 12
5 3 3 9 12 6 8 7 9 13 12 6 3 9 12 14
12 5 3 10 12 13 12 5 10 6 2 3 9 14 6 9
12 6 1 11 12 12 12 6 3 3 9 13 12 5 3 8
12 13 12 5 10 6 2 11 5 9 12 4 10 6 9 12
12 6 8 6 3 3 3 9 12 6 10 6 9 5 10 12
4 9 6 3 9 5 3 10 6 3 3 9 6 10 13 12
14 6 1 9 12 6 3 3 9 5 9 12 5 9 4 10
5 9 14 12 6 3 3 11 6 10 6 10 12 14 6 9
12 6 3 10 5 3 9 5 3 3 3 1 8 5 3 10
12 5 3 3 10 5 8 6 3 3 9 12 14 6 9 13
12 6 1 11 5 10 6 9 7 9 12 12 5 3 10 12
4 9 12 5 10 5 9 6 3 8 12 6 10 7 1 8
12 14 12 6 9 12 12 5 9 14 12 7 1 3 10 12
6 3 2 11 6 10 6 10 6 3 2 3 10 7 3 10
