16
5 11
6 11
5 3 11 5 3 1 3 11 5 9 5 1 9 7 1 11
6 9 5 10 5 8 5 3 10 12 14 12 6 9 4 9
5 10 12 5 10 14 6 3 9 6 3 10 13 12 14 12
6 3 10 6 3 3 1 9 6 3 3 9 12 6 3 8
5 9 5 9 5 3 10 6 9 5 9 12 6 9 13 12
12 6 8 6 10 13 5 3 10 14 12 6 3 10 4 10
6 9 14 5 9 4 10 5 9 5 2 1 3 11 6 9
5 10 5 10 12 12 5 10 12 6 9 14 5 3 3 10
12 5 10 5 10 6 10 13 4 3 10 5 10 7 3 9
4 10 13 6 9 7 1 8 12 5 9 12 5 9 5 8
12 5 2 9 6 9 12 6 10 12 6 10 12 6 10 12
12 12 13 12 13 12 14 5 9 12 7 3 2 3 9 12
12 12 12 6 8 12 5 10 12 6 3 3 3 9 12 12
6 10 12 5 10 6 2 11 12 5 1 3 11 6 10 12
5 3 10 12 7 1 9 5 10 12 12 5 1 11 5 10
6 3 3 2 3 10 14 6 3 10 6 10 6 3 2 11
