16
12 9
4 6
7 1 9 13 5 3 9 13 5 3 3 1 3 3 3 9
5 10 4 10 4 11 12 12 6 9 5 10 13 5 3 10
6 9 14 5 10 5 10 12 5 10 12 7 8 6 9 13
5 8 5 10 13 12 7 2 2 11 4 9 6 3 2 10
12 14 12 5 8 6 3 3 3 9 12 6 3 3 3 9
6 9 12 14 4 3 1 3 11 12 12 7 1 3 9 12
5 10 6 3 10 5 10 13 5 10 12 5 10 5 10 12
4 1 9 5 9 12 13 6 10 7 2 10 7 2 9 12
14 12 12 12 12 6 8 5 3 3 3 3 9 5 10 12
5 10 6 10 6 11 6 10 13 5 1 9 12 4 11 12
4 3 3 9 5 9 5 3 8 12 12 14 12 12 5 10
6 9 13 12 12 6 10 13 6 10 6 3 10 14 6 9
5 10 12 6 10 7 3 2 1 1 3 9 5 1 3 8
6 9 6 3 1 1 3 9 14 6 9 12 14 12 13 12
13 12 5 9 14 12 13 12 5 3 10 12 5 10 12 12
6 2 10 6 3 10 6 2 10 7 3 2 10 7 2 10
