16
3 0
5 12
5 3 3 9 5 9 5 1 9 5 9 5 1 3 9 13
12 5 3 2 10 12 14 12 14 12 6 10 12 5 10 12
12 14 5 3 9 6 9 6 9 12 5 3 10 6 3 8
12 5 10 5 10 7 2 3 10 12 6 3 3 3 9 14
4 10 5 10 5 3 9 5 9 6 3 3 3 9 6 9
4 11 6 9 4 11 12 12 12 5 1 3 11 4 11 12
12 5 9 4 10 5 10 12 6 10 6 3 3 10 5 8
12 12 12 6 11 4 9 12 7 3 3 3 1 9 12 14
14 12 6 3 9 12 6 10 5 3 3 9 12 14 6 9
5 10 5 11 12 6 9 7 2 9 13 12 6 9 5 10
12 13 4 3 10 7 2 1 3 10 6 2 9 12 6 9
12 4 10 7 3 1 9 14 5 3 9 7 8 6 9 12
12 6 3 3 3 10 12 5 10 13 6 9 6 3 10 12
6 11 5 3 1 11 12 4 9 4 3 10 5 3 3 8
5 11 12 13 6 3 10 14 12 12 5 9 12 5 3 10
6 3 2 2 3 3 3 3 10 6 10 6 10 6 3 11
