16
4 4
6 7
5 9 5 9 7 1 9 5 3 9 7 1 11 5 3 9
12 6 10 6 9 12 12 6 9 6 9 4 9 12 5 10
12 5 3 3 10 12 12 5 10 13 12 14 12 12 6 9
12 6 3 3 9 12 12 6 9 12 6 9 6 2 11 12
4 3 3 9 6 10 6 3 10 4 11 6 3 3 3 8
12 5 9 6 3 3 9 7 3 0 3 3 3 3 3 10
12 14 6 1 9 5 10 5 9 12 5 3 3 3 3 9
12 5 3 10 14 12 5 10 12 6 10 13 5 3 3 10
12 12 5 3 9 12 12 13 6 3 9 12 6 9 5 9
6 8 6 9 6 8 6 2 9 13 6 10 7 2 10 12
5 2 11 12 7 2 9 13 6 2 3 3 9 13 5 10
12 13 5 10 5 9 6 2 3 9 5 3 10 12 6 9
4 10 6 3 10 12 5 11 5 10 6 9 7 0 3 10
12 5 3 3 3 10 6 3 2 3 11 6 9 6 3 9
12 6 9 5 3 3 9 5 3 9 5 9 12 13 5 10
6 11 6 2 3 11 6 2 11 6 10 6 10 6 2 11
