16
14 14
14 2
5 3 1 9 7 3 1 3 9 5 3 3 9 5 9 13
12 5 10 6 3 9 12 7 2 10 5 9 6 10 6 8
12 6 3 1 9 6 10 5 9 5 10 6 3 3 9 12
12 7 9 12 6 3 3 10 12 6 9 5 11 5 10 12
6 9 12 6 9 5 1 11 12 13 4 10 5 10 5 10
5 10 12 5 10 14 12 5 10 12 12 5 10 5 10 13
14 5 10 12 5 9 12 6 9 4 10 12 5 10 5 8
5 10 7 2 10 6 2 9 12 6 11 4 10 7 10 12
6 3 9 5 9 7 3 8 6 3 9 12 5 3 9 12
7 9 12 12 6 3 9 4 3 11 12 12 12 13 6 8
5 10 6 10 5 9 12 12 5 3 10 6 10 12 5 10
12 5 3 3 10 6 10 14 6 3 3 9 5 8 12 13
4 10 7 3 1 9 5 3 9 5 3 10 12 12 12 12
12 7 1 3 10 6 10 5 10 12 5 9 12 6 10 12
6 9 12 13 5 3 3 10 7 2 10 12 12 5 3 8
7 2 10 6 2 3 3 3 3 3 3 10 6 10 7 10
