16
3 11
10 12
5 3 3 3 3 3 11 5 3 3 9 5 3 9 5 11
4 3 3 3 9 5 3 2 11 5 10 12 13 12 6 9
6 9 13 5 8 6 9 5 3 10 5 8 12 6 3 8
13 12 12 12 12 13 12 12 5 9 14 12 4 1 11 12
6 2 10 12 6 8 12 6 10 12 5 10 14 6 3 10
5 3 9 6 9 14 12 7 9 12 6 9 5 9 5 9
4 9 6 3 8 5 10 5 10 6 9 4 10 6 10 12
12 6 9 5 10 12 7 8 13 5 10 4 3 11 5 10
6 9 12 6 11 6 9 12 6 10 7 8 5 9 4 9
5 10 12 5 3 3 10 4 3 3 9 12 12 12 12 12
12 5 10 6 9 5 3 2 3 9 12 14 12 12 14 12
12 6 3 3 10 12 5 9 5 10 12 5 10 6 9 12
6 3 9 5 9 14 12 6 10 13 6 10 13 5 10 12
5 9 6 10 12 5 10 5 1 2 3 9 12 6 9 12
12 12 5 3 10 12 5 10 6 3 9 6 2 11 12 12
14 6 2 3 3 10 6 3 3 11 6 3 3 3 2 10
