16
15 3
8 9
5 3 3 3 3 9 5 3 3 1 11 5 3 3 3 9
4 3 9 7 3 10 12 5 11 6 3 2 3 11 5 8
6 9 12 5 9 5 2 10 5 3 3 3 9 5 10 14
7 10 4 10 6 10 5 3 10 5 9 5 10 4 3 9
5 9 6 9 5 9 12 7 1 10 6 10 7 2 11 12
12 6 9 6 8 14 6 9 6 3 3 9 5 3 3 8
6 9 12 7 10 5 9 6 9 7 1 10 4 9 5 10
5 10 6 9 5 10 6 9 6 9 12 5 10 12 6 9
12 7 3 2 10 5 9 6 9 12 12 14 5 10 13 12
4 3 3 9 5 10 6 9 12 12 6 3 10 5 8 12
12 13 5 10 6 3 11 12 6 10 5 9 5 10 12 12
6 10 6 1 3 3 9 6 3 9 12 6 2 11 12 12
5 3 9 12 5 9 6 3 9 4 10 5 3 3 8 12
12 13 12 4 10 6 3 9 12 6 9 12 7 1 10 12
12 6 8 14 5 3 9 14 12 5 10 6 9 14 5 10
6 11 6 3 10 7 2 3 10 6 3 11 6 3 2 11
