16
12 12
3 4
5 3 3 1 9 13 5 3 1 3 3 9 5 9 7 9
12 13 5 10 12 12 12 13 12 7 3 2 10 6 9 12
6 8 6 9 12 6 0 10 6 9 5 9 7 3 2 8
13 6 9 12 6 9 14 5 3 8 12 6 3 3 9 14
4 3 10 12 13 6 3 8 7 10 12 7 1 11 6 9
14 5 3 10 4 3 3 10 5 9 6 3 8 5 9 12
5 10 7 3 2 9 7 9 12 6 1 11 12 12 6 8
4 3 9 5 9 6 3 10 12 13 6 3 10 6 9 14
6 9 6 10 6 9 5 9 6 2 9 5 3 9 6 9
13 12 7 3 9 6 10 12 5 3 10 12 13 6 3 8
12 12 5 3 2 3 9 6 10 13 5 10 4 9 5 10
12 12 6 3 9 5 10 5 1 8 12 7 8 6 10 13
12 6 3 9 12 6 9 14 12 14 6 9 6 11 5 10
4 3 3 10 12 7 2 9 6 9 5 8 5 3 10 13
12 5 9 7 2 3 9 6 9 12 12 14 12 7 1 8
6 10 6 3 3 3 10 7 2 10 6 3 2 3 10 14
