16
3 11
10 7
5 3 9 5 3 9 5 3 1 9 5 9 5 9 5 9
14 5 8 12 13 6 10 5 10 12 12 6 10 12 14 12
5 10 14 6 8 5 9 12 13 12 12 5 9 6 3 8
4 3 3 3 2 10 14 12 12 6 10 12 6 3 3 10
12 5 3 1 3 3 3 10 6 1 9 6 3 9 7 9
12 12 7 10 5 3 3 9 5 10 12 7 9 12 5 8
12 6 3 9 12 5 11 12 4 9 6 3 10 6 10 12
6 3 9 6 10 6 9 12 12 6 3 3 1 3 11 12
5 11 6 3 3 3 8 12 6 3 3 11 12 5 3 10
4 3 3 1 1 11 12 12 5 3 3 9 12 12 5 9
14 5 9 12 14 5 10 6 10 5 9 12 12 6 10 12
5 10 12 4 3 10 5 1 3 10 12 12 6 3 9 12
6 9 12 6 3 9 14 12 5 9 14 6 3 9 12 12
5 10 6 3 9 6 3 8 12 6 3 3 3 10 4 10
6 3 3 9 14 5 9 14 12 5 3 3 11 5 10 13
7 3 3 2 3 10 6 3 10 6 3 3 3 2 3 10
