16
5 12
1 1
5 3 3 3 3 3 3 3 3 9 5 3 3 3 3 9
4 3 3 9 5 9 5 9 5 10 6 1 11 5 9 12
6 3 9 12 12 12 12 14 6 3 9 14 5 10 6 8
5 11 12 12 12 12 4 9 5 9 12 5 10 5 11 12
4 3 10 6 10 12 12 6 10 6 2 10 13 4 3 10
12 5 9 7 9 12 14 5 9 5 9 7 0 10 7 9
4 10 6 3 10 12 5 10 6 10 6 9 6 3 3 8
12 5 3 3 3 8 4 3 3 11 5 10 5 9 5 10
14 6 3 3 9 14 12 5 3 3 10 5 10 6 10 13
5 9 5 9 6 3 10 6 3 3 9 12 5 9 7 8
12 6 10 12 5 3 9 5 3 3 10 12 12 6 9 12
14 5 9 6 10 13 6 10 5 3 9 6 10 13 12 12
5 10 4 3 3 8 5 3 2 9 6 3 3 10 6 8
12 5 10 5 3 10 12 5 9 12 5 9 5 3 9 12
12 6 9 14 5 3 10 12 12 6 10 6 10 5 10 12
6 11 6 3 2 3 3 10 6 3 3 3 11 6 3 10
