16
13 2
10 10
5 9 5 1 9 7 3 1 3 11 5 1 3 9 5 9
12 14 12 12 12 5 3 8 5 3 10 12 5 10 12 12
6 3 10 12 12 12 5 10 12 7 9 12 6 3 10 12
5 3 9 12 6 10 14 5 2 3 10 6 3 1 9 14
12 7 2 10 5 3 3 10 13 5 3 3 9 14 6 9
4 3 3 9 6 9 5 3 8 6 9 13 6 3 9 12
6 3 9 4 11 12 4 11 6 9 12 4 3 9 6 10
13 5 10 6 3 10 14 5 9 12 12 6 9 12 5 9
12 6 3 3 3 3 3 10 4 10 12 5 10 6 10 12
12 5 3 9 5 1 11 5 10 5 10 4 3 3 9 12
4 2 11 12 12 6 3 10 13 6 9 12 13 5 10 12
14 5 9 12 6 3 9 7 0 9 12 6 10 12 7 8
5 10 12 12 5 9 6 9 14 12 6 3 9 4 9 12
12 7 2 10 12 4 11 6 9 4 1 11 12 12 12 14
12 5 3 9 12 6 3 9 12 14 12 7 10 14 6 9
6 2 11 6 2 3 11 6 2 3 2 3 3 3 3 10
