16
4 2
12 7
13 5 3 3 3 1 9 5 9 7 3 3 1 9 7 9
12 12 5 3 3 10 12 12 6 3 3 9 12 6 9 12
12 12 6 3 9 7 8 12 5 3 9 6 10 5 10 12
6 10 5 9 6 9 6 10 6 9 4 3 11 12 5 10
5 3 10 6 3 10 7 3 1 10 6 3 3 10 6 9
6 9 5 3 9 5 3 9 6 3 9 5 3 3 3 8
5 8 12 5 10 12 13 6 3 9 12 6 1 3 9 12
12 14 12 6 9 12 4 11 5 10 6 9 14 5 10 12
6 3 2 11 12 12 4 3 10 5 9 6 3 10 5 10
13 5 3 3 10 14 12 7 1 10 4 9 5 11 12 13
12 6 3 3 3 9 6 9 6 11 12 12 12 5 10 12
4 3 9 13 5 10 5 10 5 3 10 6 8 6 3 8
4 9 6 10 6 3 10 5 10 5 9 7 10 5 3 10
12 6 9 5 1 3 11 4 3 10 6 3 3 10 7 9
6 9 12 12 6 3 3 10 7 1 9 7 1 9 5 8
7 10 6 2 3 3 3 3 3 10 6 3 10 6 10 14
