16
8 4
1 10
7 3 1 3 3 3 9 5 9 5 3 9 5 3 3 9
5 3 10 5 3 3 10 12 6 10 5 10 12 5 3 10
12 7 9 12 7 9 5 2 9 13 12 7 10 6 3 9
6 9 12 6 9 6 2 11 12 6 2 3 3 3 9 12
5 10 6 3 2 3 3 9 6 3 9 5 1 11 12 12
12 5 3 3 3 9 13 6 3 9 12 14 12 5 2 10
4 10 5 3 11 12 6 3 9 12 6 9 4 10 5 9
6 3 8 5 9 6 3 9 6 2 3 10 6 9 12 12
5 9 14 12 6 3 3 10 5 3 3 3 11 14 12 12
12 6 3 8 5 3 3 9 6 3 9 7 1 3 10 12
4 9 5 10 12 7 9 6 3 9 6 3 10 13 5 10
12 12 12 13 6 9 4 9 5 0 3 3 3 10 6 9
14 12 12 4 11 12 12 12 12 14 5 3 3 3 3 10
5 10 6 8 5 10 12 12 6 9 6 9 5 3 3 9
4 3 9 14 12 5 10 12 5 2 11 12 6 9 13 12
6 11 6 3 2 10 7 10 6 3 3 2 3 10 6 10
