16
5 15
5 11
5 3 3 11 5 3 1 3 3 9 7 3 3 1 9 13
4 3 3 9 4 11 6 3 9 4 3 3 3 10 12 12
12 5 9 6 10 5 3 1 10 14 5 3 3 9 6 8
12 12 12 5 3 10 13 12 5 3 10 7 9 12 5 10
14 12 6 10 5 3 2 10 6 3 3 9 12 12 6 9
5 10 5 3 10 7 1 3 3 9 13 6 8 12 7 10
12 5 10 5 3 9 12 5 9 12 4 9 12 6 3 11
12 6 9 12 13 6 10 12 6 10 12 14 6 3 9 13
12 13 6 10 4 1 11 12 5 3 8 5 3 9 12 12
12 6 1 9 12 6 3 10 12 7 10 12 13 12 6 8
4 9 14 6 2 3 3 3 10 5 9 6 8 6 3 10
12 6 3 9 5 3 3 3 3 10 6 3 10 7 1 9
12 5 11 12 12 5 9 7 3 3 3 1 9 5 10 12
12 4 9 6 10 12 6 3 9 5 9 12 6 10 5 10
12 14 4 9 5 10 5 11 12 12 12 6 9 13 6 9
6 3 10 6 10 7 2 3 2 10 6 3 10 6 3 10
