16
7 8
2 10
5 9 5 1 3 1 3 11 5 3 3 3 1 9 7 9
12 6 10 6 9 14 5 9 4 11 5 9 12 6 9 12
12 5 9 13 12 5 10 6 10 5 10 6 10 5 10 12
6 10 14 12 4 10 7 3 9 6 9 7 9 12 5 8
5 9 5 10 6 3 3 9 6 9 12 5 10 6 10 12
12 6 10 5 3 9 7 2 3 10 12 12 5 3 9 12
6 9 7 8 13 6 3 3 3 9 12 12 12 13 6 10
5 10 5 10 6 3 3 3 9 12 12 12 6 2 3 9
12 5 8 7 1 3 1 3 10 6 10 4 1 1 11 12
12 14 6 9 4 9 14 5 1 9 7 10 12 14 5 10
6 9 5 10 12 6 3 10 12 6 3 9 6 9 12 13
13 6 10 5 10 5 3 9 6 3 9 6 1 10 12 12
4 11 5 10 7 8 13 6 9 13 12 7 10 5 10 12
4 9 6 3 3 10 6 9 12 12 6 3 9 12 7 8
12 6 3 9 5 1 3 10 6 8 5 3 10 6 9 12
6 3 11 6 10 6 3 3 3 10 6 3 3 3 2 10
