16
4 3
1 2
5 3 9 5 3 1 3 11 5 3 1 9 5 3 9 13
6 11 6 2 9 12 5 3 10 5 10 12 12 7 2 8
5 3 9 7 10 12 6 9 5 10 13 12 6 9 5 10
12 7 2 3 9 4 3 10 12 13 4 10 5 10 12 13
4 3 9 5 10 6 11 5 10 12 12 5 10 13 12 12
4 11 12 12 7 1 9 6 9 12 12 12 5 10 12 12
14 5 10 12 5 10 6 3 10 12 12 12 6 9 6 8
5 10 13 12 4 9 13 5 3 2 10 6 9 12 5 10
12 7 2 8 14 12 12 6 1 11 5 3 10 4 10 13
12 5 9 6 3 10 4 11 12 5 8 5 9 12 7 8
12 12 6 9 7 3 8 5 10 12 12 14 12 6 9 12
12 4 11 6 1 9 4 10 5 10 6 11 12 13 6 8
6 10 5 9 14 12 12 13 6 3 3 3 10 6 9 12
5 3 10 6 9 12 6 8 5 3 3 1 3 1 10 12
4 3 3 9 6 10 7 10 12 5 9 6 9 14 5 10
6 3 11 6 3 3 3 3 2 10 6 11 6 3 2 11
