16
15 11
1 1
5 9 7 1 1 3 3 11 7 9 5 3 9 7 1 9
12 6 9 12 12 5 3 3 3 10 4 9 12 5 10 14
12 7 2 10 14 6 3 9 5 11 12 12 6 10 5 9
12 5 3 9 5 9 5 10 12 5 10 12 5 3 10 12
6 10 5 10 12 6 10 7 8 12 13 12 6 9 5 8
5 3 8 5 10 5 3 3 10 6 8 12 5 10 12 14
12 5 10 12 7 0 3 3 1 11 12 6 10 13 6 9
12 6 11 6 9 6 3 9 12 5 10 7 3 8 5 8
4 3 3 9 6 3 9 12 12 12 7 1 3 8 12 14
12 5 3 2 9 13 12 14 6 2 3 10 7 10 6 9
12 6 3 9 6 10 6 3 9 5 3 3 3 3 3 8
14 5 9 6 9 5 9 5 10 4 3 3 3 3 9 14
5 10 6 3 10 12 12 6 9 6 11 5 3 9 6 9
12 5 3 3 3 10 6 9 12 5 3 10 13 12 5 10
12 6 3 3 9 7 9 12 6 10 5 1 10 12 6 9
6 3 3 3 2 3 10 6 3 3 10 6 3 2 3 10
