16
6 8
15 1
5 3 11 5 3 3 9 5 9 5 3 9 5 3 1 9
6 9 5 10 13 5 10 12 6 10 13 6 10 13 12 12
5 10 6 3 8 6 9 12 7 3 2 3 3 8 12 14
4 3 3 3 10 13 6 10 5 3 3 3 3 8 6 9
6 3 3 9 7 8 5 3 2 3 9 13 5 10 5 8
13 5 3 10 5 10 6 9 5 9 12 12 4 11 12 12
12 12 5 9 6 3 3 2 10 14 12 6 10 5 10 12
6 2 10 6 1 3 3 3 9 5 10 5 3 10 5 10
5 3 9 5 10 5 3 9 12 6 9 6 9 5 10 13
6 9 12 14 5 10 13 14 12 5 2 9 12 12 5 8
5 10 6 3 10 5 8 13 12 12 7 10 12 6 10 12
12 5 3 9 7 8 12 12 6 8 5 3 10 7 3 8
12 6 9 6 3 10 12 6 3 10 6 3 1 3 9 12
6 9 6 3 3 9 6 3 9 5 3 9 6 11 12 12
13 12 5 3 3 10 5 11 12 12 13 6 3 3 10 12
6 2 10 7 3 3 2 3 2 10 6 3 3 3 3 10
