16
2 1
4 15
5 9 5 11 7 9 5 3 3 1 3 3 1 1 9 13
12 6 10 5 9 4 10 5 9 14 5 9 14 12 12 12
12 13 5 8 12 12 13 12 6 9 12 12 5 10 12 12
12 6 8 12 12 6 8 6 9 6 10 6 10 13 12 12
6 9 12 12 12 7 8 5 10 5 3 9 7 8 6 8
13 12 12 12 6 9 14 6 9 6 9 6 9 4 3 10
12 12 14 12 13 6 3 9 4 9 12 13 12 12 5 9
12 6 3 10 6 1 9 12 14 6 2 10 12 14 12 12
4 11 5 3 1 10 14 6 9 5 3 9 12 5 10 12
4 3 10 13 6 3 1 11 12 12 5 10 4 10 5 8
12 5 9 6 3 9 6 3 10 12 12 7 8 13 12 12
12 12 6 3 3 2 3 9 7 8 6 9 12 12 12 12
12 6 3 3 9 5 9 6 3 10 13 12 6 10 12 14
6 3 3 9 6 10 12 5 9 5 10 6 3 9 4 9
13 5 9 6 3 9 12 12 6 10 5 9 5 10 14 12
6 10 6 3 3 2 10 6 3 3 10 6 2 3 3 10
