16
15 7
7 12
5 3 3 3 9 5 3 9 5 9 5 3 3 1 9 13
12 7 3 9 6 2 11 12 12 6 10 13 5 10 6 10
6 3 3 8 5 3 9 12 12 7 1 8 6 3 3 9
5 3 9 12 12 7 2 10 6 9 12 6 3 9 5 8
6 9 14 12 6 3 3 3 3 2 10 13 5 10 12 12
5 10 5 10 7 3 3 9 5 9 7 8 12 5 10 14
6 9 6 9 5 3 3 10 12 6 9 6 10 12 5 9
5 10 5 10 6 1 9 7 10 13 6 3 9 6 10 12
6 9 12 5 9 12 4 3 11 4 1 9 12 5 3 8
5 10 12 12 12 14 12 5 3 10 12 14 12 4 9 12
4 9 12 12 6 3 8 6 9 13 6 3 10 14 12 12
14 12 12 6 3 9 14 5 10 4 3 3 3 3 10 12
5 10 6 3 9 4 9 6 9 4 3 3 9 5 9 12
12 5 1 11 12 12 4 9 12 6 3 11 12 12 12 12
12 12 6 3 10 14 12 12 6 3 3 9 12 12 6 10
6 2 3 3 3 3 10 6 3 3 11 6 10 6 3 11
