16
14 0
14 11
13 5 1 11 5 3 3 3 9 5 1 3 3 3 9 13
4 10 12 5 10 5 9 13 6 10 6 3 3 9 6 10
6 9 12 6 3 10 12 6 3 3 9 5 9 12 5 9
5 10 4 3 3 9 12 5 3 9 6 10 12 6 10 12
4 11 6 3 9 14 6 10 13 12 5 3 8 13 5 10
14 5 9 5 8 5 3 3 2 10 12 5 10 12 6 9
5 10 12 12 12 6 9 7 3 3 8 12 5 2 9 14
12 13 6 10 12 13 12 5 3 3 10 12 12 5 8 13
12 12 5 3 2 10 12 6 9 5 3 10 12 12 12 12
12 12 12 13 5 3 10 5 10 6 9 5 10 12 12 12
12 6 2 8 6 9 7 8 5 3 10 14 5 10 6 8
6 9 5 2 11 6 9 12 6 3 9 5 10 5 9 12
5 10 6 9 5 9 12 4 9 13 6 10 5 10 6 10
4 9 7 10 12 6 10 14 12 4 3 3 10 5 3 9
12 6 3 9 12 7 3 1 10 6 3 9 7 8 5 10
6 3 11 6 2 3 3 10 7 3 3 2 3 10 6 11
