16
6 14
8 2
5 9 5 3 3 9 5 3 1 9 7 3 1 3 3 9
12 14 12 5 11 6 2 11 12 6 3 9 14 5 3 8
12 5 10 4 1 9 13 5 10 13 5 10 5 10 13 12
12 12 7 8 12 6 8 6 9 12 12 5 10 5 8 12
12 6 9 14 12 13 4 11 12 4 10 6 9 12 6 10
4 3 10 5 10 6 8 5 10 6 3 3 10 4 3 11
12 7 3 2 3 9 14 6 3 3 9 7 3 10 5 9
12 5 3 1 3 10 5 3 1 11 6 3 3 3 10 12
12 12 5 10 5 3 2 11 12 5 3 9 5 1 11 12
12 12 6 11 6 3 9 5 10 6 9 6 10 12 5 8
12 6 3 1 3 3 10 6 9 5 10 5 3 10 12 12
6 3 9 12 7 3 3 9 6 2 11 6 9 5 10 12
5 9 12 6 3 3 3 0 11 5 9 5 10 6 9 14
12 12 6 3 9 5 9 14 5 10 12 4 1 9 6 9
12 4 11 5 10 12 6 3 10 13 12 14 12 6 11 12
14 6 3 2 3 10 7 3 3 2 2 3 10 7 3 10
