16
14 14
11 5
13 5 1 3 3 3 3 9 7 3 9 5 3 1 3 9
4 10 6 3 9 7 9 6 3 9 12 6 9 12 7 8
4 3 3 11 6 9 4 3 9 12 4 11 12 6 9 14
12 5 3 3 9 12 6 9 14 12 6 9 4 11 6 9
14 12 5 11 12 4 9 12 5 10 5 10 12 5 9 12
5 10 12 5 10 12 12 12 12 7 0 3 10 12 6 8
4 9 12 12 7 10 12 12 6 9 12 13 5 10 13 12
12 12 4 10 5 3 10 4 3 10 6 10 12 5 8 12
12 12 12 5 8 7 9 6 3 9 5 3 8 14 6 10
12 12 12 14 4 9 6 1 3 10 12 7 10 5 3 9
12 12 6 9 14 6 9 6 3 3 8 5 3 10 5 10
12 6 9 6 3 9 12 7 3 9 14 4 9 13 6 9
6 11 12 5 11 12 6 3 9 6 9 14 12 4 9 12
5 1 10 6 3 2 3 3 2 9 6 3 10 12 12 12
12 14 5 3 3 3 9 7 3 2 11 5 9 12 6 10
6 3 2 3 3 11 6 3 3 3 3 10 6 2 3 11
