16
1 8
7 14
5 9 13 5 3 3 3 11 5 3 3 9 5 3 1 9
12 6 10 6 9 5 3 3 2 11 5 10 12 5 10 12
6 9 5 9 4 2 3 3 11 5 8 5 10 12 13 12
13 6 10 12 14 5 3 3 9 12 14 4 11 12 4 10
12 5 9 6 9 12 7 3 8 4 3 10 5 10 12 13
12 12 6 3 10 4 3 9 12 6 3 11 12 5 10 12
12 6 9 5 9 6 11 12 6 9 5 3 10 12 5 8
4 3 10 12 6 3 3 10 5 10 12 13 5 10 12 12
12 7 3 2 1 3 9 5 10 5 8 6 2 3 10 12
6 3 3 9 4 11 12 12 7 10 6 9 5 11 5 10
5 3 9 12 14 5 10 6 9 5 9 12 6 3 2 9
12 5 10 6 3 10 13 5 10 12 6 8 5 9 5 10
12 6 3 3 1 3 10 12 5 8 7 10 12 12 6 9
12 7 1 9 6 3 9 12 14 6 3 9 12 12 7 10
12 5 10 12 5 9 12 12 5 3 9 6 10 6 3 9
6 10 7 2 10 14 6 2 10 7 2 3 3 3 3 10
