16
10 11
4 13
5 3 1 1 3 3 9 7 3 3 3 3 1 3 1 9
12 5 10 14 5 9 6 3 3 3 3 9 4 11 12 12
12 6 3 3 10 12 7 3 3 1 3 10 14 5 10 12
12 13 5 3 3 10 5 3 9 6 3 3 3 10 13 12
12 12 6 9 5 9 12 13 12 5 3 9 5 9 4 10
12 4 9 12 12 6 10 12 12 6 9 12 12 6 2 9
6 10 14 12 12 5 1 10 6 3 10 12 14 5 9 14
5 9 5 10 6 10 12 5 3 9 5 8 5 10 6 9
12 6 10 5 9 5 10 12 7 2 10 14 12 5 9 12
4 3 3 10 12 6 9 6 3 3 3 3 10 14 12 12
12 7 9 5 2 9 12 5 9 7 3 3 1 9 6 10
4 3 10 6 9 14 6 10 6 3 9 5 10 6 3 9
14 5 9 5 8 5 3 3 9 5 10 12 5 9 5 10
5 10 6 10 12 12 5 3 10 12 5 10 12 14 6 9
12 7 3 3 10 12 6 3 3 10 12 5 8 5 3 10
6 3 3 3 3 2 3 3 3 3 10 14 6 2 3 11
