16
5 11
4 5
5 9 5 3 9 5 3 9 5 9 7 1 1 9 5 9
12 6 10 5 10 12 5 2 10 6 9 12 12 4 10 14
12 7 9 6 9 12 14 5 3 9 12 14 12 14 5 9
6 9 6 3 8 12 5 10 5 10 6 1 10 5 10 12
5 10 5 9 6 10 6 9 12 7 3 10 5 10 5 8
12 5 10 6 1 3 9 12 12 5 3 3 8 5 10 14
4 10 5 9 6 11 4 10 6 10 5 9 12 6 3 9
6 9 12 6 3 9 14 5 3 3 10 12 12 5 3 8
13 12 6 9 13 6 9 12 5 3 3 10 14 12 7 8
6 10 5 10 4 9 12 12 6 3 9 5 9 6 9 12
5 11 12 7 8 6 10 6 9 13 12 12 12 5 10 12
12 7 2 9 12 5 3 1 10 6 2 10 6 10 7 10
6 9 5 10 6 10 5 10 5 3 3 3 3 3 3 9
5 10 4 3 3 9 6 11 12 5 1 3 3 3 11 12
6 9 6 3 11 6 3 3 2 10 14 5 9 5 9 12
7 2 3 3 3 3 3 3 3 3 3 10 6 10 6 10
