16
1 10
3 11
5 3 1 9 5 1 11 5 1 3 9 7 1 9 7 9
12 13 12 12 14 6 3 10 12 7 2 3 10 6 3 8
12 12 12 6 3 3 3 9 4 9 5 3 3 9 13 12
6 10 12 13 5 3 3 10 12 12 12 5 9 12 6 8
5 3 10 12 6 3 9 7 8 6 2 10 12 6 9 12
12 7 1 0 3 11 6 9 14 5 9 7 2 9 12 12
6 9 12 6 3 3 9 12 5 10 6 3 9 14 12 14
5 10 6 3 9 13 6 2 10 5 9 7 2 9 4 9
4 9 7 3 2 2 11 5 3 10 6 9 5 10 12 12
12 12 5 3 3 3 9 6 9 13 5 10 12 5 10 12
12 6 10 13 5 9 6 3 10 12 12 7 8 14 5 8
6 3 9 4 10 6 1 9 5 8 6 9 6 3 10 12
13 5 10 12 13 5 10 6 10 6 9 12 5 3 9 12
12 6 9 12 12 12 5 3 3 3 10 12 14 13 4 10
12 5 10 6 10 12 6 9 7 9 5 10 5 10 6 9
6 2 3 3 3 10 7 2 3 10 6 3 10 7 3 10
