16
12 8
7 15
13 5 9 5 1 3 9 5 11 5 3 3 1 9 5 11
4 10 6 10 6 9 14 12 13 6 9 5 10 12 6 9
12 5 11 5 9 6 9 12 6 3 8 6 9 6 3 10
12 6 3 10 12 5 10 6 3 9 12 13 6 9 5 9
6 3 9 5 8 6 1 3 11 12 6 0 11 6 10 12
5 3 10 12 12 13 12 5 9 6 9 14 5 3 3 8
12 5 3 8 12 12 6 10 6 9 6 3 10 5 11 12
12 4 11 12 6 2 3 9 13 6 9 5 3 2 3 10
12 12 5 10 5 9 5 10 4 11 6 10 5 9 7 9
12 14 6 1 10 12 12 7 2 1 3 3 10 6 3 8
6 3 9 14 5 10 6 9 5 10 5 3 3 9 5 10
7 9 6 3 10 5 9 12 12 13 12 7 9 12 6 9
5 8 5 11 5 10 12 12 12 12 6 3 8 6 3 10
12 6 10 5 10 13 12 12 12 4 3 9 6 3 3 9
4 3 9 6 3 8 6 10 12 4 9 14 5 3 9 12
6 11 6 3 3 2 3 3 10 14 6 3 2 11 6 10
