16
8 7
15 0
5 1 9 5 3 3 9 7 3 1 1 3 3 9 7 9
12 12 6 10 5 9 6 3 9 14 12 7 9 6 9 12
12 6 3 3 8 12 7 9 12 5 10 5 2 11 12 12
12 5 3 9 12 6 9 6 8 6 9 12 5 3 2 8
12 6 9 12 6 11 4 9 6 3 10 6 10 5 9 12
14 5 10 12 5 9 14 12 5 3 9 5 9 12 12 14
5 8 7 2 10 6 9 12 12 13 6 10 6 10 6 9
12 14 5 3 3 9 12 6 2 2 9 7 3 9 5 10
6 9 12 13 5 10 6 3 3 9 6 3 3 8 6 9
5 10 6 10 12 5 9 5 11 6 3 3 9 6 11 12
12 5 9 5 10 12 12 12 5 3 3 9 6 3 3 8
6 10 6 10 7 8 6 8 12 5 9 6 9 5 9 12
13 5 1 3 9 6 9 12 12 12 6 9 6 10 12 12
4 10 6 9 6 9 12 14 12 12 7 8 13 5 10 12
12 5 9 12 7 2 10 5 10 6 9 6 8 12 5 10
6 10 14 6 3 3 3 2 3 3 10 7 10 6 2 11
