16
6 9
13 4
13 5 3 9 5 3 3 1 3 9 5 3 1 3 3 9
12 6 9 6 10 7 9 6 9 12 6 9 6 3 9 12
6 3 2 3 1 3 2 11 12 12 7 0 3 11 12 12
5 3 3 9 14 5 3 3 10 6 9 12 5 9 12 14
12 7 3 8 5 10 7 1 9 5 10 12 12 12 6 9
6 3 9 6 10 5 9 14 12 6 9 14 12 6 9 12
13 5 10 7 1 10 12 5 2 9 6 3 10 13 12 12
12 12 7 1 10 7 2 10 5 10 5 1 3 8 6 8
6 10 5 10 5 9 5 9 4 11 12 6 9 6 11 12
5 9 4 9 12 6 10 12 12 5 10 5 10 5 3 10
12 6 10 12 12 5 11 12 14 6 9 6 9 12 5 9
12 5 9 6 10 4 9 6 3 9 12 13 6 10 12 12
12 14 4 9 5 10 6 1 9 6 10 4 3 9 12 12
6 9 12 6 2 11 5 10 6 9 7 2 9 6 10 12
13 12 6 3 11 5 10 5 11 6 3 9 6 3 11 12
6 2 3 3 3 10 7 2 3 3 3 2 3 3 3 10
