16
10 6
8 2
13 5 1 3 3 3 3 3 3 9 5 1 3 3 9 13
4 10 12 7 1 3 3 1 11 12 14 6 3 9 12 12
12 13 6 9 6 3 9 12 5 10 5 3 3 10 12 12
4 10 5 10 7 3 10 12 6 3 10 5 3 9 12 12
12 5 10 5 3 9 5 2 9 5 3 10 13 6 8 12
14 6 9 12 7 2 10 5 10 12 5 3 10 13 12 12
5 3 10 4 3 9 7 10 5 10 4 3 9 12 6 10
12 5 11 6 9 6 9 5 10 7 10 5 8 6 3 9
12 6 1 11 12 5 10 6 3 3 9 12 12 7 9 12
6 9 12 5 10 6 3 3 3 9 6 10 4 3 10 12
5 10 12 6 3 9 5 9 13 6 3 3 10 5 9 12
12 7 2 3 3 2 10 4 2 3 3 9 13 12 6 10
4 3 9 5 3 9 5 10 5 9 7 2 10 12 7 9
12 13 12 4 11 12 12 13 12 12 5 3 9 6 3 8
6 8 12 12 5 10 6 10 12 6 10 13 6 1 11 12
7 10 6 10 6 3 3 3 2 3 3 2 11 6 3 10
