16
7 14
7 4
5 1 11 5 9 5 1 9 7 1 3 3 3 1 3 11
12 6 3 10 6 10 12 6 9 12 5 3 3 10 5 9
6 3 11 5 3 3 8 7 2 10 14 5 3 3 10 12
5 3 3 10 5 3 10 5 3 3 3 2 3 11 5 8
4 3 9 7 2 11 5 10 7 1 9 5 3 1 10 14
12 5 10 5 9 5 10 5 9 14 12 6 9 14 5 9
14 6 3 10 12 6 3 10 6 9 6 9 6 3 10 12
5 3 3 1 2 3 3 3 11 6 1 2 3 11 5 10
4 3 9 14 5 9 5 3 3 3 10 5 3 9 6 9
6 9 6 3 10 6 10 5 9 13 5 10 5 2 3 10
5 10 5 3 9 5 3 8 6 8 6 9 12 13 13 13
6 3 10 13 12 4 11 6 9 6 9 12 6 10 12 12
5 9 5 8 12 12 5 3 10 7 8 6 3 3 10 12
12 6 10 6 10 14 4 3 3 9 6 9 7 3 3 8
12 5 9 5 3 9 14 5 9 12 13 6 3 3 3 8
6 10 6 10 7 2 3 10 6 10 6 3 3 3 3 10
