16
9 7
0 14
5 3 9 7 1 3 11 5 3 3 9 5 9 5 1 11
4 9 12 5 10 5 3 10 13 5 10 12 12 14 4 9
12 12 4 10 5 10 13 5 8 6 3 10 6 9 12 12
14 12 14 5 10 7 8 12 6 3 9 5 3 10 14 12
5 8 5 10 5 3 10 6 9 13 12 6 11 5 3 10
12 14 6 9 12 5 3 3 2 10 4 3 9 12 5 9
4 3 3 10 4 2 3 11 5 3 10 13 12 4 10 12
12 5 3 9 6 9 5 3 10 5 3 8 12 6 9 12
12 12 7 8 5 10 6 9 7 2 9 14 12 7 10 12
12 4 9 14 12 5 3 10 5 9 4 9 12 5 9 12
12 14 6 1 10 12 5 1 10 12 14 12 12 12 6 10
12 5 9 14 5 10 12 6 9 6 3 10 12 6 1 9
6 10 6 3 10 13 12 13 6 9 5 9 6 9 12 12
5 3 3 1 3 10 6 0 11 12 12 12 5 10 12 12
12 7 9 12 5 1 11 12 5 10 12 12 12 7 10 12
6 3 10 6 10 6 3 10 6 3 10 6 2 3 3 10
