16
4 4
2 2
5 3 1 9 13 5 3 9 7 3 3 1 3 1 3 11
12 13 12 12 12 12 13 12 5 3 9 4 9 14 5 9
6 8 12 6 8 12 12 12 6 9 12 14 12 5 10 12
5 10 12 5 10 12 12 6 3 10 12 5 8 6 9 12
12 5 10 4 11 6 2 9 5 11 12 12 6 11 12 12
14 12 13 12 5 3 3 10 12 7 10 4 3 3 10 12
5 10 4 10 6 9 5 3 2 3 9 12 13 5 9 12
6 9 14 5 9 12 12 5 3 11 12 12 12 12 12 12
5 10 5 10 12 6 10 4 3 3 10 6 8 12 12 12
12 5 10 13 6 3 3 10 7 1 3 9 12 12 6 8
12 12 5 0 9 5 3 3 3 10 13 12 12 6 9 12
12 12 12 12 12 12 5 3 9 5 2 10 4 11 12 12
12 12 14 12 6 10 12 7 10 6 3 9 14 5 10 12
12 6 9 4 9 13 4 3 1 11 5 10 5 10 13 12
4 3 10 14 12 12 12 13 6 3 10 5 10 5 8 12
6 3 3 3 10 6 2 2 3 3 3 10 7 10 6 10
