16
2 8
12 11
5 3 1 3 1 11 5 3 9 13 5 9 5 1 3 9
6 11 6 9 14 5 10 5 10 12 12 6 10 12 5 10
5 3 3 10 5 10 13 12 5 2 2 3 11 12 6 9
12 5 9 5 10 7 8 12 6 3 11 5 9 6 9 12
4 10 12 4 3 3 10 12 5 9 5 10 6 3 10 12
6 9 6 10 7 3 3 10 12 6 10 5 1 3 11 12
13 12 5 3 3 3 3 9 4 9 5 10 6 9 5 10
12 6 10 7 1 9 13 12 12 12 6 9 5 8 6 9
6 3 1 3 8 6 10 12 12 12 7 10 12 12 5 10
5 9 12 13 12 5 9 12 12 12 5 3 10 14 12 13
12 6 10 4 10 12 6 10 12 12 12 5 3 9 6 8
12 5 9 6 11 12 5 9 12 12 6 10 5 8 5 10
12 12 6 9 5 10 12 6 10 12 5 3 10 12 12 13
12 12 13 6 10 7 8 13 5 10 4 3 9 14 6 8
12 12 4 3 3 9 6 10 12 13 6 9 12 5 3 10
6 2 10 7 3 2 3 3 10 6 3 10 6 2 3 11
