16
10 8
1 4
7 1 9 5 1 3 9 5 9 5 3 3 1 3 3 9
5 10 12 14 12 13 6 10 12 12 5 9 6 3 9 12
12 5 10 5 10 6 3 1 10 6 10 6 9 13 12 12
12 6 9 12 5 3 9 12 5 9 7 3 2 8 12 12
4 9 12 12 12 5 10 6 10 6 9 5 9 12 12 12
14 12 12 12 12 6 3 3 9 13 6 10 12 14 12 12
5 10 6 8 6 3 9 13 12 4 3 9 6 9 12 12
12 5 11 12 7 9 12 12 12 12 13 4 11 12 12 14
12 4 9 6 9 12 14 12 12 6 8 12 5 10 4 9
12 12 6 9 4 2 3 10 6 9 14 12 6 9 12 12
12 6 9 6 10 5 3 3 9 6 9 4 3 10 14 12
12 13 12 5 9 12 7 9 6 9 12 6 9 7 1 10
12 6 10 12 12 6 9 6 9 6 10 13 6 9 4 9
4 3 9 12 4 11 6 9 4 3 1 10 5 10 14 12
6 9 12 12 6 3 3 10 12 7 10 5 10 7 1 8
7 10 6 10 7 3 3 3 2 3 3 2 3 3 10 14
