16
2 14
1 8
13 5 3 1 1 3 3 9 5 3 3 9 5 1 3 11
4 10 13 12 14 5 9 6 10 5 11 12 12 6 3 9
12 5 10 12 5 10 6 3 9 12 5 10 4 3 11 12
12 12 5 8 6 9 5 11 12 12 12 7 10 5 9 12
6 8 12 6 9 6 8 5 10 6 2 3 3 10 12 12
13 12 6 9 6 9 12 6 3 3 3 3 9 13 6 8
12 12 13 6 9 14 6 9 5 3 3 9 12 4 9 12
4 10 6 9 6 1 11 6 10 5 3 10 12 14 12 12
6 9 5 2 11 12 5 1 9 12 5 11 6 9 12 12
13 12 12 5 9 12 12 12 14 12 4 3 9 12 6 10
6 2 10 12 12 12 12 6 9 12 6 11 12 6 3 9
5 3 9 12 12 4 2 11 4 2 3 3 2 11 5 10
6 9 6 10 12 14 7 9 6 11 5 3 3 9 6 9
5 10 5 9 6 9 5 10 5 9 6 9 13 6 3 8
12 7 8 6 9 6 10 7 8 6 9 12 4 3 9 12
6 3 10 7 2 3 3 3 10 7 2 10 6 11 6 10
