16
11 8
3 8
5 9 5 3 3 3 3 9 5 9 5 1 9 7 3 9
12 14 6 1 11 5 9 4 10 6 8 12 6 3 3 8
4 3 3 10 5 10 12 14 5 9 14 12 5 3 3 10
6 3 9 5 10 7 2 3 10 6 3 10 6 9 5 11
5 9 12 6 3 3 9 5 3 9 5 3 11 12 6 9
12 12 12 7 1 9 12 12 13 12 6 3 3 2 3 8
14 12 12 5 10 12 6 10 12 6 3 3 3 9 7 10
5 10 6 10 5 10 7 3 2 3 1 3 9 12 5 9
4 3 3 1 2 3 3 9 5 9 6 9 14 6 8 12
12 5 9 14 5 3 9 6 10 6 3 10 5 9 12 12
12 12 6 9 6 9 6 3 9 5 9 5 10 12 12 12
12 6 9 12 5 8 13 13 12 12 6 10 13 12 12 12
14 5 10 12 12 12 12 4 10 6 9 5 2 10 14 12
5 10 7 8 12 14 12 6 3 9 12 6 3 9 5 8
4 3 9 6 10 5 10 5 3 10 6 9 13 12 12 12
6 11 6 3 3 10 7 2 3 3 3 10 6 2 10 14
