16
5 9
4 6
7 1 3 11 5 3 1 3 3 3 3 9 5 9 5 9
5 10 5 3 10 5 10 5 9 7 1 2 10 6 10 14
12 5 2 11 5 8 5 10 6 9 14 5 9 5 3 9
4 10 5 3 10 12 6 3 9 6 3 10 6 10 5 8
6 9 6 9 7 2 3 11 12 5 3 11 5 9 12 12
13 6 9 12 5 3 3 9 12 12 5 3 10 12 12 14
4 9 12 6 2 11 5 10 12 4 2 11 5 8 6 9
12 14 6 9 5 3 10 5 10 14 5 9 12 6 9 12
12 5 3 10 6 3 3 8 7 1 10 6 8 7 10 12
12 12 5 3 11 5 9 6 9 12 7 3 10 5 9 12
12 12 6 9 5 10 6 9 12 6 3 9 5 10 6 8
12 6 3 8 6 9 7 8 6 3 3 8 12 13 5 10
4 3 9 12 13 6 9 12 5 9 7 8 12 12 6 9
12 13 6 10 6 3 10 6 10 6 9 12 12 12 5 10
6 2 3 9 7 3 3 3 1 9 12 14 12 4 10 13
7 3 3 2 3 3 3 3 10 14 6 3 10 6 3 10
