16
7 9
4 5
13 5 3 1 9 5 9 5 3 9 13 5 3 3 1 9
12 6 9 12 14 12 14 12 7 2 8 4 3 11 12 12
4 11 12 6 3 10 7 0 3 9 14 12 5 9 12 12
4 3 10 13 5 1 9 12 13 6 3 10 12 6 10 12
12 5 9 4 10 12 12 6 10 5 3 3 10 5 3 10
12 12 12 12 5 10 12 5 3 10 5 3 3 10 5 11
12 14 4 10 12 7 2 10 7 9 6 3 3 9 6 9
6 9 6 11 4 9 5 3 3 8 5 3 9 6 3 8
13 12 5 9 14 12 12 5 9 14 4 11 12 5 3 10
12 6 10 6 3 10 12 12 12 5 10 5 10 12 5 9
4 11 5 3 3 1 8 12 6 10 13 6 9 12 12 12
4 3 10 5 3 10 12 6 9 5 2 11 6 10 14 12
6 9 5 10 7 3 10 5 10 4 3 3 3 1 9 12
13 12 12 5 3 3 9 6 9 6 3 3 11 12 12 12
4 10 12 12 7 9 6 3 10 5 3 9 5 10 6 8
6 11 6 2 3 2 3 3 3 10 7 2 10 7 3 10
