16
15 4
8 4
5 3 9 5 9 5 9 5 9 5 3 1 9 7 1 9
6 9 12 12 6 10 12 14 12 12 5 10 6 9 12 12
5 10 12 6 9 13 6 9 6 10 12 5 9 6 10 12
12 7 2 9 12 4 11 6 3 9 12 14 4 3 9 12
4 3 9 12 12 4 3 9 5 10 6 9 4 9 14 12
6 9 12 6 10 6 9 12 12 5 9 12 14 6 9 12
13 12 6 3 3 9 14 12 12 12 12 4 3 9 12 12
12 6 3 9 5 10 5 10 6 10 12 6 9 12 6 10
4 3 3 10 12 7 0 3 3 9 12 5 10 6 3 9
6 9 5 9 6 9 6 3 11 6 8 14 5 9 5 8
5 10 12 14 5 10 5 3 3 9 6 3 10 12 12 14
6 3 8 5 10 5 10 13 5 10 5 11 5 10 6 9
5 11 12 6 3 2 3 10 6 9 4 9 6 9 5 8
6 3 10 5 3 3 9 5 3 10 14 12 5 10 12 12
5 3 11 12 5 9 12 6 9 5 3 10 6 3 10 12
6 3 3 10 14 6 2 3 10 6 3 3 3 3 3 10
