16
8 0
2 12
7 9 5 3 3 9 7 3 3 1 1 11 5 1 3 9
5 8 6 9 13 12 5 3 9 12 12 5 10 6 9 14
12 12 5 10 6 8 12 13 12 12 6 2 3 11 6 9
12 14 6 3 9 12 12 12 12 6 3 9 5 3 3 8
4 1 3 9 12 6 10 4 10 5 9 14 6 9 5 10
14 12 13 12 6 9 5 10 5 10 6 3 3 10 12 13
5 10 12 12 5 10 4 3 10 7 9 5 9 5 10 12
4 9 4 10 12 7 10 5 9 13 4 10 6 10 5 8
14 12 6 9 6 3 9 12 6 10 12 7 3 3 8 12
5 10 13 12 7 9 12 12 5 11 6 3 3 9 14 12
4 9 6 2 9 12 12 12 12 5 9 5 9 12 5 8
12 6 3 9 12 12 12 12 4 10 6 10 12 12 12 12
6 11 5 10 6 10 6 10 6 9 5 9 6 10 12 14
5 3 8 5 3 1 11 5 9 12 12 6 3 3 2 9
4 9 14 12 5 10 5 10 6 10 6 11 5 3 3 8
14 6 3 10 6 3 2 3 3 3 3 3 10 7 3 10
