16
5 9
11 4
5 9 5 1 9 5 9 5 1 3 3 3 9 5 3 9
12 6 10 12 14 12 12 12 12 7 3 9 6 10 13 12
12 13 5 10 5 10 6 10 6 1 9 12 7 9 4 10
12 12 6 3 10 5 9 5 9 12 12 12 5 10 6 9
4 2 11 5 9 12 6 10 6 10 12 12 4 9 5 10
12 5 9 12 6 10 5 3 1 11 12 12 14 6 2 9
12 12 6 8 5 9 12 13 12 5 10 6 3 3 9 14
12 6 9 14 12 12 4 10 12 6 3 9 5 11 6 9
4 11 6 3 10 12 12 5 2 3 11 12 12 5 3 10
14 5 3 9 5 10 12 6 3 3 1 2 10 6 9 13
5 10 5 10 6 9 4 11 5 9 12 13 5 3 10 12
12 13 12 5 3 8 14 5 10 12 6 8 12 5 3 8
12 12 6 8 7 10 5 2 11 12 5 10 12 12 5 10
12 6 3 10 5 9 12 5 3 10 6 11 6 10 12 13
12 5 3 3 10 6 10 12 5 3 9 5 9 5 10 12
6 2 3 3 3 3 11 6 2 11 6 10 6 2 3 10
