16
11 13
11 1
5 3 1 3 9 7 3 3 1 3 9 5 9 13 5 9
12 13 12 7 2 3 3 3 10 7 8 12 12 6 10 12
6 8 6 9 5 11 5 3 3 9 6 10 6 3 3 8
5 10 5 8 12 7 8 13 5 10 5 9 7 3 9 12
6 9 12 12 12 5 10 12 6 3 10 6 3 9 4 10
13 12 12 14 6 10 5 2 3 3 11 5 9 12 6 9
12 12 6 1 3 11 4 3 3 3 3 8 12 6 9 12
12 12 13 6 3 9 6 9 13 5 9 12 12 5 10 12
12 6 2 1 11 12 5 10 12 12 12 12 12 6 9 14
4 9 5 10 5 8 12 5 10 12 12 12 4 11 6 9
12 12 6 9 12 14 6 8 5 10 12 14 6 1 11 12
14 12 5 10 6 1 11 12 6 9 12 5 9 6 9 12
5 10 6 3 9 6 3 10 13 12 6 10 4 3 10 12
6 9 5 9 6 3 3 9 12 12 5 9 14 5 3 10
5 10 12 6 1 3 11 6 8 6 10 6 3 10 7 9
6 3 2 11 6 3 3 3 2 3 3 3 3 3 3 10
