16
2 6
5 8
5 9 5 3 1 11 5 3 3 1 3 3 3 3 9 13
12 12 12 13 6 9 6 1 11 12 5 1 1 11 12 12
12 6 10 4 9 6 3 10 5 10 14 12 14 5 10 12
6 9 5 10 12 5 3 3 10 5 9 4 9 12 5 8
13 6 10 13 12 12 5 3 3 10 12 12 12 12 12 14
4 9 5 8 12 12 6 3 9 5 10 12 6 10 6 9
12 6 10 6 10 6 3 3 10 12 13 6 3 3 9 12
12 5 9 7 3 1 1 3 11 12 12 5 3 9 12 12
6 10 6 3 9 12 14 5 9 12 12 12 13 6 10 12
13 5 3 9 12 6 9 12 12 12 12 12 4 1 3 10
12 12 13 6 10 5 8 12 6 10 12 12 12 14 5 9
12 12 4 9 7 8 12 6 3 9 6 2 10 5 10 12
12 6 10 6 3 10 6 9 5 10 5 3 3 10 13 12
4 1 3 11 5 3 9 12 6 3 2 3 3 3 10 12
12 6 3 9 12 13 12 12 7 9 5 3 3 11 5 8
6 3 11 6 2 10 6 2 3 10 6 3 3 3 10 14
