16
0 3
12 6
7 1 9 7 1 3 3 1 11 5 9 5 1 3 3 11
5 10 6 9 6 11 5 10 5 10 6 10 12 5 3 9
4 9 13 12 5 9 6 3 10 5 3 9 6 8 5 10
14 12 6 2 10 6 3 3 9 12 13 6 9 14 6 9
5 8 5 3 3 3 3 9 6 10 4 9 6 3 3 8
12 14 6 1 11 5 3 10 7 1 10 12 5 3 9 12
4 9 5 10 5 10 7 1 3 10 7 8 12 13 6 10
12 6 10 5 10 5 1 10 5 3 9 12 12 4 1 11
14 5 9 12 5 10 12 5 10 13 12 12 12 12 6 9
5 10 4 10 6 11 12 6 9 12 12 12 12 14 5 8
12 5 10 5 3 9 6 9 6 8 12 14 6 9 12 14
12 14 5 2 11 12 5 10 5 10 6 3 3 10 6 9
6 9 6 9 7 10 4 9 12 5 3 3 9 7 1 8
5 2 11 6 9 13 12 6 10 12 5 11 6 9 12 14
4 3 3 9 12 12 12 5 3 10 4 1 11 12 6 9
6 3 11 6 10 6 2 10 7 3 10 6 3 2 3 10
