32
8 2
8 24
5 1 3 9 7 3 1 11 5 3 9 5 9 5 9 5 9 5 9 5 3 1 9 5 3 3 3 9 5 3 3 9
14 12 7 2 3 3 10 5 10 13 12 12 6 10 6 10 12 12 6 2 11 12 12 6 11 5 9 6 10 5 3 8
5 8 5 3 3 9 5 10 5 10 6 10 5 3 3 3 10 6 3 9 5 10 6 9 5 10 6 3 3 10 5 10
12 14 12 7 3 2 10 7 8 5 9 5 10 5 3 3 9 5 3 10 12 7 1 10 12 13 5 3 1 11 12 13
4 9 6 3 3 3 3 9 6 10 12 12 7 8 5 11 12 6 9 13 6 9 6 9 12 6 2 11 6 3 2 10
12 6 1 11 5 1 11 6 11 5 10 12 5 10 6 1 10 7 2 10 5 8 7 2 10 5 3 3 3 3 3 9
12 5 10 5 10 6 3 3 3 2 9 12 6 3 9 6 3 3 9 5 10 14 5 3 9 4 3 3 3 3 11 12
12 6 9 12 5 3 3 3 9 5 10 6 9 5 10 7 3 1 10 6 3 3 2 11 6 10 5 9 5 3 9 12
12 5 10 12 6 11 5 3 8 6 3 3 10 4 9 5 9 12 7 1 3 3 3 3 3 3 10 6 10 5 10 12
12 6 9 6 3 9 4 9 6 3 3 3 11 12 6 10 12 6 3 10 5 1 3 3 3 3 3 9 13 6 3 8
4 11 4 1 11 12 12 6 3 3 3 3 9 4 3 11 12 5 3 3 10 12 5 3 3 9 13 6 2 3 9 12
12 5 10 14 5 10 14 5 9 5 3 9 6 10 5 3 10 6 3 11 5 10 4 11 5 10 4 11 5 3 10 12
12 6 3 3 10 5 1 10 12 6 9 6 3 3 10 5 3 3 3 9 12 5 10 5 10 7 2 9 4 3 11 12
12 5 1 3 9 14 12 7 2 3 10 5 9 5 3 10 7 9 5 10 6 10 5 10 5 3 1 10 12 5 9 12
12 14 6 9 6 9 4 3 3 9 5 8 12 6 3 9 5 10 12 5 3 9 12 5 10 5 10 5 10 12 6 10
6 9 5 10 13 12 6 9 13 12 14 12 6 3 3 10 4 3 10 12 13 12 12 12 5 2 11 12 13 6 9 13
5 10 12 13 4 10 13 6 8 6 9 12 13 5 3 3 2 3 9 12 12 6 10 12 14 5 9 6 0 11 6 8
12 5 10 12 12 5 2 3 2 11 12 12 6 2 11 5 3 9 6 8 6 3 3 2 3 10 6 9 12 5 9 12
12 12 5 10 12 6 11 5 3 3 10 12 5 3 3 2 11 12 7 10 5 9 5 3 3 9 5 10 12 12 12 12
12 12 4 3 10 5 3 10 7 1 3 8 6 9 7 9 5 10 5 3 10 12 6 3 9 12 6 1 10 12 6 10
6 10 6 3 9 12 7 3 1 10 7 2 11 6 3 8 6 3 10 7 9 6 3 3 10 6 9 6 9 6 3 9
5 3 1 11 6 10 5 3 10 5 3 3 9 5 9 12 13 5 1 3 2 3 3 9 5 11 6 9 12 5 3 10
12 13 6 3 3 1 10 5 9 6 9 13 6 10 12 12 4 10 6 9 5 11 5 10 12 5 1 10 14 6 9 13
6 2 9 5 11 6 3 10 6 9 6 8 13 5 10 12 14 5 3 10 6 9 12 5 10 12 14 5 3 9 6 8
5 9 12 6 3 9 5 3 9 12 5 10 12 12 5 10 5 10 5 3 9 12 12 6 9 6 9 12 13 12 5 10
12 12 6 9 5 10 6 9 12 12 6 3 8 12 12 5 8 5 2 9 6 8 6 9 4 11 6 10 12 6 10 13
12 6 9 12 6 3 1 10 12 6 3 3 10 12 12 14 12 6 9 6 9 12 13 12 6 9 5 1 2 3 9 12
6 11 12 6 3 9 12 5 8 5 3 9 5 10 6 3 10 13 6 9 12 6 8 6 9 6 8 12 5 9 6 8
5 3 2 1 11 12 12 12 12 6 9 12 12 5 3 3 1 10 5 10 12 5 2 11 6 9 14 12 12 6 9 12
12 5 9 12 5 10 12 12 6 3 10 12 12 12 5 9 12 5 10 13 12 12 5 1 9 6 9 12 6 9 14 12
4 10 12 14 6 9 14 12 5 11 5 10 12 12 14 12 6 10 7 8 12 14 12 12 6 11 12 6 9 4 3 10
6 11 6 3 3 2 3 10 6 3 2 11 6 2 3 2 3 3 3 10 6 3 10 6 3 3 2 3 10 6 3 11
